aardvark	rdvrk
abactinally	bctnlly
abacus	bcs
abandonedly	bndndly
abasedly	bsdly
abashedly	bshdly
abbreviately	bbrvtly
abdomen	bdmn
abdominally	bdmnlly
abidingly	bdngly
ability	blty
abiologically	blgclly
abjectly	bjctly
ably	bly
abnormally	bnrmlly
abolishment	blshmnt
abominably	bmnbly
aboriginally	brgnlly
abortively	brtvly
aboundingly	bndngly
abridgedly	brdgdly
abruptedly	brptdly
abruptly	brptly
absently	bsntly
absorbedly	bsrbdly
abstemiously	bstmsly
absurdly	bsrdly
abundantly	bndntly
abusefully	bsflly
abusively	bsvly
abysmally	bysmlly
academically	cdmclly
accelerant	cclrnt
accelerator	cclrtr
accentually	ccntlly
acceptably	ccptbly
acceptedly	ccptdly
access	ccss
accessibly	ccssbly
accessively	ccssvly
accessorily	ccssrly
accident	ccdnt
accidently	ccdntly
accommodation	ccmmdtn
accompanist	ccmpnst
accordion	ccrdn
account	ccnt
accountably	ccntbly
accountant	ccntnt
accurately	ccrtly
accursedly	ccrsdly
accusably	ccsbly
accusatively	ccstvly
accusingly	ccsngly
acervately	crvtly
achiever	chvr
achingly	chngly
acicularly	cclrly
acidly	cdly
acoustic	cstc
acoustics	cstcs
acquisitively	cqstvly
acrimoniously	crmnsly
acrocephaly	crcphly
acrogenously	crgnsly
acromegaly	crmgly
acronically	crnclly
acropetally	crptlly
acrylic	crylc
actinally	ctnlly
actinically	ctnclly
action	ctn
actionably	ctnbly
actively	ctvly
activity	ctvty
actor	ctr
actress	ctrss
actuarially	ctrlly
acupuncture	cpnctr
ad	d
adamically	dmclly
adapter	dptr
adaptively	dptvly
addedly	dddly
addition	ddtn
additionally	ddtnlly
additively	ddtvly
address	ddrss
adequately	dqtly
adherently	dhrntly
adhesively	dhsvly
adiabatically	dbtclly
adjacently	djcntly
adjectively	djctvly
adjoinedly	djndly
adjunctly	djnctly
adjustably	djstbly
adjustment	djstmnt
admirably	dmrbly
admiredly	dmrdly
admiringly	dmrngly
admissibly	dmssbly
admittedly	dmttdly
admonitively	dmntvly
admonitorily	dmntrly
adnominally	dnmnlly
adoptedly	dptdly
adorally	drlly
adorningly	drnngly
adradially	drdlly
adrenalin	drnln
adroitly	drtly
adult	dlt
adulterately	dltrtly
adulterously	dltrsly
adulthood	dlthd
advancement	dvncmnt
advantage	dvntg
adverbially	dvrblly
advertising	dvrtsng
advice	dvc
advisedly	dvsdly
advisorily	dvsrly
aerobically	rbclly
aerobiotically	rbtclly
aerogenically	rgnclly
aeronautically	rntclly
aerophilately	rphltly
affably	ffbly
affair	ffr
affect	ffct
affectedly	ffctdly
affinely	ffnly
affirmably	ffrmbly
affluently	fflntly
aftermath	ftrmth
afternoon	ftrnn
aftershave	ftrshv
aftershock	ftrshck
agamically	gmclly
age	g
agedly	gdly
agency	gncy
agenda	gnd
agent	gnt
aggregately	ggrgtly
aggression	ggrssn
aggrievedly	ggrvdly
agitatedly	gttdly
agonizedly	gnzdly
agonizingly	gnzngly
agrarianly	grrnly
agreeably	grbly
agreeingly	grngly
agreement	grmnt
aimfully	mflly
aimlessly	mlssly
air	r
airbag	rbg
airbus	rbs
airfare	rfr
airforce	rfrc
airily	rly
airline	rln
airmail	rml
airplane	rpln
airport	rprt
airship	rshp
airtightly	rtghtly
alarm	lrm
alarmedly	lrmdly
alarmingly	lrmngly
alb	lb
albatross	lbtrss
alcohol	lchl
alcove	lcv
alder	ldr
aldermanly	ldrmnly
alertly	lrtly
algebra	lgbr
allegedly	llgdly
allenarly	llnrly
allergist	llrgst
alliably	llbly
allicholly	llchlly
alligator	llgtr
allowably	llwbly
allowedly	llwdly
alluringly	llrngly
allusively	llsvly
almanac	lmnc
almightily	lmghtly
alodially	ldlly
aloofly	lfly
alpaca	lpc
alpenglow	lpnglw
alpenhorn	lpnhrn
alpha	lph
alphabet	lphbt
alpinely	lpnly
alterably	ltrbly
alternately	ltrntly
alternative	ltrntv
altitude	lttd
alto	lt
aluminium	lmnm
amateurishly	mtrshly
amazingly	mzngly
ambassador	mbssdr
ambiguously	mbgsly
ambition	mbtn
ambitiously	mbtsly
amblingly	mblngly
ambrosially	mbrslly
ambulance	mblnc
amenably	mnbly
amendment	mndmnt
americanly	mrcnly
amicably	mcbly
amorously	mrsly
amorphously	mrphsly
amount	mnt
amphibiously	mphbsly
amphiboly	mphbly
amusedly	msdly
amusement	msmnt
amusingly	msngly
amusively	msvly
anaerobically	nrbclly
anagogically	nggclly
anagram	ngrm
analgesia	nlgs
anally	nlly
analogously	nlgsly
analogue	nlg
analogy	nlgy
analysis	nlyss
analyst	nlyst
anatomically	ntmclly
anatomy	ntmy
anciently	ncntly
anerly	nrly
aneurismally	nrsmlly
angerly	ngrly
angiomegaly	ngmgly
angiosperm	ngsprm
angle	ngl
anglicanly	nglcnly
angora	ngr
angstrom	ngstrm
anguish	ngsh
anguishously	ngshsly
angularly	nglrly
animal	nml
animally	nmlly
animatedly	nmtdly
animately	nmtly
animatingly	nmtngly
anisocotyly	nsctyly
ankle	nkl
anklet	nklt
annoyingly	nnyngly
annual	nnl
annularly	nnlrly
anodically	ndclly
anomalously	nmlsly
anomaly	nmly
anonymously	nnymsly
anorak	nrk
answer	nswr
answerably	nswrbly
anteater	nttr
antechamber	ntchmbr
antelope	ntlp
anthony	nthny
anticly	ntcly
antidotally	ntdtlly
antimonopoly	ntmnply
antiquarianly	ntqrnly
antiquely	ntqly
antler	ntlr
antrorsely	ntrrsly
ants	nts
anxiety	nxty
anybody	nybdy
anything	nythng
anywhere	nywhr
aoristically	rstclly
apagogically	pggclly
apartment	prtmnt
aperiodically	prdclly
aperitif	prtf
apertly	prtly
aphetically	phtclly
aphylly	phylly
apishly	pshly
apogamically	pgmclly
apogamously	pgmsly
apology	plgy
apometaboly	pmtbly
apparatus	pprts
apparel	pprl
apparently	pprntly
appealingly	pplngly
appearance	pprnc
appeasably	ppsbly
appendix	ppndx
appetently	pptntly
applaudably	ppldbly
applause	ppls
applewood	pplwd
appliably	pplbly
appliance	pplnc
applicably	pplcbly
application	pplctn
appliedly	ppldly
appointment	ppntmnt
appositively	ppstvly
appreciably	pprcbly
approval	pprvl
approvedly	pprvdly
appulsively	pplsvly
apron	prn
apsidally	psdlly
aptly	ptly
aquatically	qtclly
aquifer	qfr
arabesquely	rbsqly
arbitrarily	rbtrrly
arboreally	rbrlly
arcadianly	rcdnly
arch-rival	rch-rvl
archaically	rchclly
archeology	rchlgy
archer	rchr
architect	rchtct
architecture	rchtctr
arctically	rctclly
arcuately	rctly
ardently	rdntly
arduously	rdsly
areologically	rlgclly
argument	rgmnt
argutely	rgtly
arithmetic	rthmtc
arm-rest	rm-rst
armadillo	rmdll
armament	rmmnt
armchair	rmchr
armoire	rmr
army	rmy
aromatically	rmtclly
arrantly	rrntly
arrival	rrvl
arrogantly	rrgntly
arrow	rrw
arterially	rtrlly
artfully	rtflly
artichoke	rtchk
article	rtcl
articulately	rtcltly
artificer	rtfcr
artificially	rtfclly
artlessly	rtlssly
ascot	sct
aseptically	sptclly
asexually	sxlly
ash	sh
ashamedly	shmdly
ashram	shrm
ashtray	shtry
ask	sk
askingly	skngly
asparagus	sprgs
aspect	spct
asperously	sprsly
aspersively	sprsvly
asphalt	sphlt
aspiringly	sprngly
assembly	ssmbly
assertively	ssrtvly
assertorily	ssrtrly
assessably	ssssbly
assidually	ssdlly
assiduously	ssdsly
assignably	ssgnbly
assignment	ssgnmnt
assishly	ssshly
assist	ssst
assistance	ssstnc
assistant	ssstnt
associate	ssct
association	ssctn
associatively	ssctvly
assumedly	ssmdly
assumingly	ssmngly
assumption	ssmptn
assuredly	ssrdly
assuringly	ssrngly
astely	stly
asterisk	strsk
astrakhan	strkhn
astrolabe	strlb
astrologer	strlgr
astrology	strlgy
astronomy	strnmy
astuciously	stcsly
astutely	sttly
atelier	tlr
athenianly	thnnly
athlete	thlt
athletics	thltcs
atmosphere	tmsphr
atom	tm
atomically	tmclly
atonally	tnlly
atoningly	tnngly
atrium	trm
atrociously	trcsly
attachedly	ttchdly
attachment	ttchmnt
attack	ttck
attempt	ttmpt
attendant	ttndnt
attention	ttntn
attentively	ttntvly
attently	ttntly
attic	ttc
attitude	tttd
attorney	ttrny
attraction	ttrctn
attunely	ttnly
audience	dnc
auditorially	dtrlly
auditorily	dtrly
auditorium	dtrm
augmentedly	gmntdly
augustly	gstly
auntly	ntly
aureously	rsly
auriculately	rcltly
aurorally	rrlly
austerely	strly
authenticly	thntcly
authorisation	thrstn
authority	thrty
authorization	thrztn
authorly	thrly
autoeciously	tcsly
autogenously	tgnsly
automatically	tmtclly
automaton	tmtn
autonomically	tnmclly
autonomously	tnmsly
autoptically	tptclly
autostyly	tstyly
autumnally	tmnlly
auxetically	xtclly
auxiliarly	xlrly
auxinically	xnclly
availingly	vlngly
avalanche	vlnch
avariciously	vrcsly
avengingly	vngngly
average	vrg
averagely	vrgly
avertedly	vrtdly
avidiously	vdsly
avoidably	vdbly
avowably	vwbly
avowedly	vwdly
awakeningly	wknngly
awareness	wrnss
awesomely	wsmly
awkwardly	wkwrdly
axially	xlly
axiologically	xlgclly
axiomatically	xmtclly
azimuth	zmth
azimuthally	zmthlly
babe	bb
babies	bbs
babishly	bbshly
baboon	bbn
babushka	bbshk
baby	bby
babyishly	bbyshly
bachelorly	bchlrly
back	bck
backbone	bckbn
backdrop	bckdrp
background	bckgrnd
backpack	bckpck
bacon	bcn
bacterially	bctrlly
baddishly	bddshly
badge	bdg
badger	bdgr
badgerly	bdgrly
badly	bdly
bafflement	bfflmnt
baggage	bggg
baggily	bggly
bagpipe	bgpp
bail	bl
bairnly	brnly
baker	bkr
bakerly	bkrly
bakery	bkry
bakeware	bkwr
bakingly	bkngly
balaclava	blclv
balalaika	bllk
balance	blnc
balcony	blcny
baldly	bldly
balefully	blflly
balkingly	blkngly
ball	bll
ballet	bllt
balloon	blln
ballpark	bllprk
balmily	blmly
bamboo	bmb
banally	bnlly
banana	bnn
band	bnd
bandana	bndn
bandanna	bndnn
bandolier	bndlr
banefully	bnflly
bangle	bngl
banjo	bnj
bank	bnk
bankbook	bnkbk
banker	bnkr
banquette	bnqtt
baobab	bbb
barbarously	brbrsly
barbeque	brbq
barber	brbr
barbiturate	brbtrt
barefacedly	brfcdly
barge	brg
baritone	brtn
barkingly	brkngly
barometer	brmtr
barracks	brrcks
barrenly	brrnly
barruly	brrly
barstool	brstl
basally	bslly
baseball	bsbll
baselessly	bslssly
basely	bsly
basement	bsmnt
bashfully	bshflly
basically	bsclly
basin	bsn
basket	bskt
basketball	bsktbll
bass	bss
bassinet	bssnt
bassoon	bssn
bastardly	bstrdly
bath	bth
bather	bthr
bathhouse	bthhs
bathrobe	bthrb
bathroom	bthrm
bathtub	bthtb
battery	bttry
batting	bttng
battleship	bttlshp
bawdily	bwdly
bayardly	byrdly
bayou	by
beam	bm
beamily	bmly
beamingly	bmngly
bean	bn
beanstalk	bnstlk
bearably	brbly
beastily	bstly
beastlily	bstlly
beatifically	btfclly
beautiful	btfl
beautifully	btflly
beauty	bty
beaver	bvr
becomingly	bcmngly
bed	bd
bedroom	bdrm
beds	bds
beech	bch
beef	bf
beefily	bfly
beerily	brly
beerishly	brshly
beet	bt
beetle	btl
beggar	bggr
beggarly	bggrly
beggingly	bggngly
beginner	bgnnr
beginning	bgnnng
begonia	bgn
beguilingly	bglngly
behavior	bhvr
beheading	bhdng
behest	bhst
behoovefully	bhvflly
behoovingly	bhvngly
belatedly	bltdly
belfry	blfry
belief	blf
believe	blv
believingly	blvngly
bellicosely	bllcsly
bellows	bllws
bells	blls
belt	blt
belyingly	blyngly
bemoaningly	bmnngly
bemusedly	bmsdly
beneficially	bnfclly
beneficiary	bnfcry
benefit	bnft
benignly	bngnly
beret	brt
berry	brry
beseemingly	bsmngly
beseemly	bsmly
besiegingly	bsgngly
besottedly	bsttdly
bestseller	bstsllr
beverage	bvrg
beverly	bvrly
bewailingly	bwlngly
beyond	bynd
biannually	bnnlly
biaxially	bxlly
biblically	bblclly
bibliophily	bblphly
bibliopoly	bblply
bibulously	bblsly
biconically	bcnclly
bicycle	bcycl
biddably	bddbly
bidet	bdt
bienly	bnly
bifariously	bfrsly
bifidly	bfdly
bifilarly	bflrly
bifocals	bfcls
bifurcately	bfrctly
big-rig	bg-rg
bigamously	bgmsly
bigotedly	bgtdly
bihourly	bhrly
bijou	bj
bikes	bks
bikini	bkn
bilaterally	bltrlly
bilingually	blnglly
biliously	blsly
billboard	bllbrd
billiardly	bllrdly
billy	blly
bimanually	bmnlly
bimonthly	bmnthly
binately	bntly
binocularly	bnclrly
binomially	bnmlly
biology	blgy
bionomically	bnmclly
bipartitely	bprttly
bipinnately	bpnntly
biplane	bpln
biquarterly	bqrtrly
birdbath	brdbth
birdcage	brdcg
birdhouse	brdhs
birds	brds
birth	brth
birthday	brthdy
biserially	bsrlly
biseriately	bsrtly
bisexually	bsxlly
biternately	btrntly
bitingly	btngly
bitterly	bttrly
biweekly	bwkly
biyearly	byrly
bizarrely	bzrrly
blackboard	blckbrd
blackfish	blckfsh
blackly	blckly
bladder	blddr
blade	bld
blamably	blmbly
blamefully	blmflly
blamingly	blmngly
blandly	blndly
blank	blnk
blanket	blnkt
blankly	blnkly
blatantly	bltntly
blately	bltly
blazer	blzr
blazingly	blzngly
bleakly	blkly
bleatingly	bltngly
blessedly	blssdly
blight	blght
blind	blnd
blindedly	blnddly
blinker	blnkr
blister	blstr
blithely	blthly
blizzard	blzzrd
block	blck
blocker	blckr
blolly	bllly
bloodflow	bldflw
bloom	blm
bloomers	blmrs
blossom	blssm
blouse	bls
blow	blw
blowfly	blwfly
blowgun	blwgn
blowhole	blwhl
blueberry	blbrry
bluffly	blffly
bluntly	blntly
boastfully	bstflly
boatload	btld
boatly	btly
boatyard	btyrd
bobbishly	bbbshly
bobcat	bbct
bobfly	bbfly
bodaciously	bdcsly
body	bdy
bog	bg
boisterously	bstrsly
bolero	blr
bolly	blly
bomber	bmbr
bonairly	bnrly
bondsman	bndsmn
bonelessly	bnlssly
bongo	bng
bonnet	bnnt
bonnily	bnnly
bonus	bns
boobily	bbly
boogeyman	bgymn
book	bk
bookcase	bkcs
bookend	bknd
bookishly	bkshly
booklet	bklt
booster	bstr
bootlessly	btlssly
boots	bts
boozily	bzly
border	brdr
bore	br
boringly	brngly
bosom	bsm
botanically	btnclly
botany	btny
botchedly	btchdly
botcherly	btchrly
botchily	btchly
botfly	btfly
bottle	bttl
bottling	bttlng
bottom	bttm
bottom-line	bttm-ln
boudoir	bdr
bough	bgh
bounceably	bncbly
bouncingly	bncngly
boundary	bndry
boundedly	bnddly
boundly	bndly
bounteously	bntsly
bountifully	bntflly
bovinely	bvnly
bow	bw
bower	bwr
bowingly	bwngly
bowl	bwl
bowler	bwlr
bowling	bwlng
bowly	bwly
bowtie	bwt
box	bx
boxer	bxr
boxspring	bxsprng
boyfriend	byfrnd
boyishly	byshly
brace	brc
bracelet	brclt
bracingly	brcngly
bracket	brckt
brake	brk
brambly	brmbly
branch	brnch
brand	brnd
brandy	brndy
brass	brss
brassiere	brssr
brassily	brssly
bratwurst	brtwrst
brave	brv
bravely	brvly
brawly	brwly
brazenly	brznly
bread	brd
breadcrumb	brdcrmb
breakably	brkbly
breakfast	brkfst
breakpoint	brkpnt
breastplate	brstplt
breeze	brz
breezily	brzly
bremely	brmly
bribery	brbry
brick	brck
brickly	brckly
bridally	brdlly
bridely	brdly
bridge	brdg
brief	brf
briefly	brfly
briefs	brfs
brightly	brghtly
brilliant	brllnt
brimfully	brmflly
briskly	brskly
bristly	brstly
british	brtsh
britishly	brtshly
brittlely	brttlly
broccoli	brccl
brochure	brchr
broiler	brlr
broilingly	brlngly
brokenly	brknly
broker	brkr
bronchitis	brnchts
bronco	brnc
bronze	brnz
brooch	brch
broodingly	brdngly
broom	brm
brother	brthr
brotherly	brthrly
brow	brw
brown	brwn
brownly	brwnly
brush	brsh
brushfire	brshfr
brushing	brshng
brusquely	brsqly
brutally	brtlly
brutely	brtly
brutishly	brtshly
bubble	bbbl
bubbly	bbbly
buccally	bcclly
bucket	bckt
buckishly	bckshly
buckle	bckl
bucolically	bclclly
buddy	bddy
budget	bdgt
buffer	bffr
buffet	bfft
buggy	bggy
bugle	bgl
building	bldng
bulb	blb
bulldozer	blldzr
bullishly	bllshly
bumper	bmpr
bumpily	bmply
bumpingly	bmpngly
bumpkinly	bmpknly
bumptiously	bmptsly
bunch	bnch
bunchily	bnchly
bungalow	bnglw
bungerly	bngrly
bunghole	bnghl
bunkhouse	bnkhs
buoyantly	byntly
burglar	brglr
burlesque	brlsq
burlesquely	brlsqly
burlily	brlly
burn	brn
burn-out	brn-t
burningly	brnngly
burst	brst
bus	bs
bush	bsh
bushes	bshs
bushily	bshly
business	bsnss
bust	bst
bustle	bstl
butane	btn
butcher	btchr
butter	bttr
butterfly	bttrfly
button	bttn
buxomly	bxmly
buyer	byr
buzzard	bzzrd
buzzardly	bzzrdly
buzzingly	bzzngly
byously	bysly
c-clamp	c-clmp
cabbage	cbbg
cabin	cbn
cabinet	cbnt
cable	cbl
caboose	cbs
cactus	ccts
cadaverously	cdvrsly
caddishly	cddshly
caddy	cddy
cadet	cdt
cadgily	cdgly
caecally	cclly
caenostyly	cnstyly
caerphilly	crphlly
cafe	cf
caftan	cftn
cagily	cgly
cajolingly	cjlngly
cake	ck
cakes	cks
calamitously	clmtsly
calcareously	clcrsly
calcification	clcfctn
calculation	clcltn
calculator	clcltr
calculus	clcls
calendar	clndr
calico	clc
caliginously	clgnsly
callously	cllsly
calm	clm
calmingly	clmngly
calmly	clmly
calumniously	clmnsly
camel	cml
cameo	cm
camera	cmr
camp	cmp
campaign	cmpgn
campanile	cmpnl
canal	cnl
cancer	cncr
cancerously	cncrsly
candelabra	cndlbr
candidate	cnddt
candidly	cnddly
candle	cndl
candy	cndy
cankeredly	cnkrdly
cannibally	cnnblly
cannily	cnnly
cannon	cnnn
canon	cnn
canonically	cnnclly
canopy	cnpy
canorously	cnrsly
canteen	cntn
cantily	cntly
cantingly	cntngly
canvas	cnvs
capably	cpbly
capaciously	cpcsly
capercally	cprclly
caperingly	cprngly
capillarily	cpllrly
capital	cptl
capitally	cptlly
capitularly	cptlrly
capitulation	cptltn
capon	cpn
cappelletti	cpplltt
cappuccino	cppccn
capriciously	cprcsly
captain	cptn
captainly	cptnly
captiously	cptsly
captivately	cptvtly
caravan	crvn
carbon	crbn
card	crd
cardboard	crdbrd
cardigan	crdgn
cardinally	crdnlly
cardiomegaly	crdmgly
care	cr
career	crr
careeringly	crrngly
carefully	crflly
carelessly	crlssly
caressively	crssvly
carload	crld
carnation	crntn
carousingly	crsngly
carpenter	crpntr
carpet	crpt
carpingly	crpngly
carport	crprt
carriage	crrg
carrier	crrr
carrot	crrt
carry	crry
cars	crs
cartilage	crtlg
cartload	crtld
cartridge	crtrdg
cascade	cscd
case	cs
casement	csmnt
cash	csh
cashier	cshr
casino	csn
cassabully	cssblly
casserole	cssrl
cassock	cssck
castanet	cstnt
castanets	cstnts
castle	cstl
catacomb	ctcmb
catamaran	ctmrn
catch	ctch
catchfly	ctchfly
category	ctgry
caterpillar	ctrpllr
cathedral	cthdrl
catholicly	cthlcly
catonically	ctnclly
cats	cts
catsup	ctsp
cattily	cttly
cattishly	cttshly
cattle	cttl
caudally	cdlly
cauliflower	clflwr
causally	cslly
causelessly	cslssly
caustically	cstclly
causticly	cstcly
cautelously	ctlsly
cautiously	ctsly
cavalierly	cvlrly
cave	cv
cavernously	cvrnsly
cavilingly	cvlngly
cd	cd
ceiling	clng
celebration	clbrtn
celeriac	clrc
celery	clry
celeste	clst
celestially	clstlly
cell	cll
cellar	cllr
cellularly	clllrly
celtically	cltclly
cement	cmnt
cemetery	cmtry
cenotaph	cntph
censoriously	cnsrsly
censurably	cnsrbly
census	cnss
center	cntr
centimeter	cntmtr
centrally	cntrlly
centuply	cntply
centurion	cntrn
cephalopod	cphlpd
ceramic	crmc
cerebrally	crbrlly
ceremonially	crmnlly
certainly	crtnly
certifiably	crtfbly
certification	crtfctn
cespitosely	csptsly
cessantly	cssntly
cesspool	csspl
chafe	chf
chain	chn
chainstay	chnsty
chair	chr
chairlift	chrlft
chairman	chrmn
chairperson	chrprsn
chalet	chlt
chalice	chlc
chalk	chlk
challenge	chllng
champion	chmpn
chance	chnc
chandelier	chndlr
change	chng
changeably	chngbly
channel	chnnl
chaos	chs
chaotically	chtclly
chap	chp
chapel	chpl
chapter	chptr
character	chrctr
charcoaly	chrcly
chard	chrd
charge	chrg
chargeably	chrgbly
charitably	chrtbly
charity	chrty
charlatan	chrltn
charles	chrls
charmedly	chrmdly
chart	chrt
chastity	chstty
chasuble	chsbl
chateau	cht
chattily	chttly
chauffeur	chffr
chauvinist	chvnst
cheaply	chply
cheatingly	chtngly
check	chck
checkroom	chckrm
cheek	chk
cheekily	chkly
cheerfully	chrflly
cheerily	chrly
cheeringly	chrngly
cheetah	chth
chemical	chmcl
chemically	chmclly
chemistry	chmstry
cheque	chq
cherries	chrrs
cherry	chrry
chess	chss
chest	chst
chestily	chstly
chicken	chckn
chickens	chckns
chicory	chcry
chidingly	chdngly
chiefly	chfly
chiffonier	chffnr
child	chld
childhood	chldhd
childly	chldly
children	chldrn
chill	chll
chillily	chllly
chilly	chlly
chime	chm
chimpanzee	chmpnz
chipmunk	chpmnk
chiromegaly	chrmgly
chirpily	chrply
chiselly	chslly
chit-chat	cht-cht
chivalry	chvlry
chive	chv
chocolate	chclt
choice	chc
choicely	chcly
choker	chkr
chokingly	chkngly
cholericly	chlrcly
choosingly	chsngly
chopstick	chpstck
chorally	chrlly
chordally	chrdlly
chowder	chwdr
christly	chrstly
chrome	chrm
chronometer	chrnmtr
chub	chb
chubbily	chbbly
chug	chg
chummily	chmmly
chunkily	chnkly
church	chrch
churchly	chrchly
churn	chrn
chylocauly	chylcly
cicada	ccd
cicely	ccly
cicely	ccly
cigarette	cgrtt
ciliately	cltly
cinema	cnm
circinately	crcntly
circle	crcl
circuitously	crctsly
circularly	crclrly
circulation	crcltn
cirrus	crrs
citizenly	ctznly
citizenship	ctznshp
city	cty
civically	cvclly
civilisation	cvlstn
clammily	clmmly
clamorously	clmrsly
clank	clnk
clapboard	clpbrd
clarinet	clrnt
clasp	clsp
class	clss
classic	clssc
classroom	clssrm
clause	cls
clavately	clvtly
clave	clv
clavicle	clvcl
clavier	clvr
cleaner	clnr
cleanly	clnly
cleat	clt
cleavage	clvg
cleavingly	clvngly
clef	clf
clemently	clmntly
clerically	clrclly
clerk	clrk
clerkly	clrkly
cleverly	clvrly
client	clnt
cliff	clff
climate	clmt
climb	clmb
clinically	clnclly
clip	clp
clipper	clppr
cliquishly	clqshly
cloak	clk
cloakedly	clkdly
cloakroom	clkrm
clock	clck
clockwork	clckwrk
cloddily	clddly
cloggily	clggly
clogs	clgs
cloister	clstr
cloisterly	clstrly
closely	clsly
cloth	clth
clothes	clths
clothing	clthng
cloudburst	cldbrst
cloudy	cldy
clouterly	cltrly
cloyingly	clyngly
club	clb
clubbily	clbbly
clue	cl
clumsily	clmsly
clutch	cltch
co-producer	c-prdcr
coach	cch
coactively	cctvly
coadunatively	cdntvly
coaxially	cxlly
coaxingly	cxngly
cob	cb
cobbly	cbbly
cobweb	cbwb
cockily	cckly
cockpit	cckpt
cockroach	cckrch
cocksurely	ccksrly
cocktail	ccktl
cocoa	cc
codon	cdn
codpiece	cdpc
coequally	cqlly
coercibly	crcbly
coercively	crcvly
coetaneously	ctnsly
coeternally	ctrnlly
coevally	cvlly
coevolution	cvltn
coffee	cff
coffin	cffn
cogently	cgntly
coggly	cggly
cogitantly	cgtntly
cogitatively	cgttvly
cognitively	cgntvly
cognizably	cgnzbly
coherently	chrntly
cohesively	chsvly
coinsurance	cnsrnc
cold	cld
coldly	cldly
coliseum	clsm
collection	cllctn
college	cllg
collegiately	cllgtly
collinearly	cllnrly
collingly	cllngly
collision	cllsn
colloquia	cllq
colloquially	cllqlly
collusively	cllsvly
colon	cln
colonially	clnlly
colonisation	clnstn
colony	clny
color	clr
colorably	clrbly
colorfully	clrflly
colossally	clsslly
coltishly	cltshly
column	clmn
columnist	clmnst
comatosely	cmtsly
comb	cmb
combat	cmbt
combatively	cmbtvly
combination	cmbntn
combine	cmbn
combinedly	cmbndly
comelily	cmlly
comely	cmly
comfort	cmfrt
comfortable	cmfrtbl
comic	cmc
comically	cmclly
comma	cmm
command	cmmnd
comment	cmmnt
commerce	cmmrc
commercial	cmmrcl
commission	cmmssn
committee	cmmtt
commodiously	cmmdsly
common	cmmn
commonly	cmmnly
communally	cmmnlly
communicant	cmmncnt
communication	cmmnctn
community	cmmnty
compactly	cmpctly
company	cmpny
comparably	cmprbly
comparison	cmprsn
compassion	cmpssn
competition	cmpttn
competitor	cmpttr
complaint	cmplnt
complement	cmplmnt
completely	cmpltly
complex	cmplx
complexly	cmplxly
compliably	cmplbly
comply	cmply
component	cmpnnt
composedly	cmpsdly
composer	cmpsr
compositely	cmpstly
composition	cmpstn
compost	cmpst
compulsion	cmplsn
computably	cmptbly
computer	cmptr
comradely	cmrdly
comradeship	cmrdshp
concavely	cncvly
concealedly	cncldly
concededly	cncddly
conceitedly	cnctdly
conceivably	cncvbly
concentrate	cncntrt
concept	cncpt
concern	cncrn
concisely	cncsly
conclusion	cnclsn
concrete	cncrt
concretely	cncrtly
condignly	cndgnly
condition	cndtn
condominium	cndmnm
condor	cndr
conductor	cndctr
cone	cn
conference	cnfrnc
confidence	cnfdnc
confinedly	cnfndly
confirmation	cnfrmtn
conflict	cnflct
confusably	cnfsbly
confusedly	cnfsdly
confusion	cnfsn
congenially	cngnlly
congo	cng
congress	cngrss
congruously	cngrsly
conically	cnclly
conicopoly	cncply
conifer	cnfr
conjoinedly	cnjndly
conjointly	cnjntly
conjugally	cnjglly
conjugately	cnjgtly
connately	cnntly
connection	cnnctn
connotively	cnntvly
conoidally	cndlly
conoidically	cndclly
consciously	cnscsly
consent	cnsnt
consequence	cnsqnc
consideration	cnsdrtn
consist	cnsst
consolably	cnslbly
consonant	cnsnnt
conspirator	cnsprtr
constant	cnstnt
consul	cnsl
consulate	cnslt
consumedly	cnsmdly
contact	cntct
contagion	cntgn
contagiously	cntgsly
content	cntnt
contest	cntst
context	cntxt
continent	cntnnt
continually	cntnlly
continuately	cntntly
continuedly	cntndly
continuously	cntnsly
contract	cntrct
contrarily	cntrrly
contrary	cntrry
contribution	cntrbtn
contritely	cntrtly
control	cntrl
contumely	cntmly
convection	cnvctn
convenably	cnvnbly
conversation	cnvrstn
conversely	cnvrsly
convert	cnvrt
convertible	cnvrtbl
convexedly	cnvxdly
convexly	cnvxly
convivially	cnvvlly
convolutely	cnvltly
cooingly	cngly
cooking	ckng
cookishly	ckshly
coolheadedly	clhddly
coolingly	clngly
coolly	clly
coonily	cnly
coonskin	cnskn
cooruptibly	crptbly
cop-out	cp-t
copiously	cpsly
copper	cppr
copulatively	cpltvly
copy	cpy
copyright	cpyrght
copywriter	cpywrtr
cordately	crdtly
cordially	crdlly
corduroy	crdry
cork	crk
cormorant	crmrnt
corn	crn
corner	crnr
cornerstone	crnrstn
cornet	crnt
corporally	crprlly
corporately	crprtly
corral	crrl
correctly	crrctly
corridor	crrdr
corrigibly	crrgbly
corrosively	crrsvly
corruption	crrptn
corruptly	crrptly
corsage	crsg
cortically	crtclly
cosily	csly
cosmically	csmclly
cost	cst
costally	cstlly
costively	cstvly
costly	cstly
costume	cstm
cot	ct
cottage	cttg
cotton	cttn
cougar	cgr
cough	cgh
council	cncl
councilman	cnclmn
councilor	cnclr
count	cnt
countably	cntbly
counterly	cntrly
counterpaly	cntrply
countess	cntss
country	cntry
county	cnty
couple	cpl
courage	crg
courageously	crgsly
courteously	crtsly
courtierly	crtrly
cousinly	csnly
couthily	cthly
covariate	cvrt
cover	cvr
coverall	cvrll
covertly	cvrtly
covetingly	cvtngly
covetously	cvtsly
covinously	cvnsly
cow	cw
cowardly	cwrdly
cowbell	cwbll
cowboy	cwby
cows	cws
coyly	cyly
cozeningly	cznngly
cozily	czly
crabbedly	crbbdly
crack	crck
cracker	crckr
crackers	crckrs
crackly	crckly
cradle	crdl
craft	crft
craftily	crftly
craftsman	crftsmn
craggily	crggly
cranially	crnlly
crankly	crnkly
crapulously	crplsly
crassly	crssly
crate	crt
cravat	crvt
cravenly	crvnly
cravingly	crvngly
crawdad	crwdd
crawly	crwly
crayfish	cryfsh
crayon	cryn
crazedly	crzdly
crazily	crzly
crazy	crzy
creakingly	crkngly
creamily	crmly
creative	crtv
creche	crch
credently	crdntly
credenza	crdnz
credibly	crdbly
credit	crdt
creditably	crdtbly
creditor	crdtr
credulously	crdlsly
creme brulee	crm brl
crenately	crntly
crest	crst
cretaceously	crtcsly
crew	crw
crib	crb
cribbage	crbbg
cribrately	crbrtly
cricket	crckt
cricketer	crcktr
crime	crm
criminal	crmnl
crimsonly	crmsnly
crinoline	crnln
cripply	crpply
crispily	crsply
criteria	crtr
criterion	crtrn
criticism	crtcsm
croakily	crkly
crocodile	crcdl
crocus	crcs
croissant	crssnt
crookedly	crkdly
crooningly	crnngly
cross	crss
crotch	crtch
croup	crp
croupily	crply
crowd	crwd
crowdedly	crwddly
crowingly	crwngly
crown	crwn
crozzly	crzzly
crucially	crclly
cruciately	crctly
crucily	crcly
crumbly	crmbly
crumply	crmply
crush	crsh
crusily	crsly
crustedly	crstdly
crustily	crstly
cry	cry
cryingly	cryngly
cubbishly	cbbshly
cubically	cbclly
cubicly	cbcly
cuckoo	cck
cucullately	cclltly
cucumber	ccmbr
cuddly	cddly
culinarily	clnrly
culpably	clpbly
cultivably	cltvbly
cultivar	cltvr
cultivator	cltvtr
culturally	cltrlly
culture	cltr
culvert	clvrt
cumbly	cmbly
cumbrously	cmbrsly
cummerbund	cmmrbnd
cumulately	cmltly
cumulatively	cmltvly
cunningly	cnnngly
cup	cp
cupboard	cpbrd
cupcake	cpck
curably	crbly
curatively	crtvly
curdly	crdly
curl	crl
curledly	crldly
curler	crlr
curliewurly	crlwrly
curlily	crlly
curlingly	crlngly
curly	crly
currency	crrncy
current	crrnt
currently	crrntly
currishly	crrshly
cursedly	crsdly
cursively	crsvly
cursor	crsr
cursorily	crsrly
curtailedly	crtldly
curtain	crtn
curtly	crtly
curve	crv
curvedly	crvdly
cushion	cshn
cussedly	cssdly
custard	cstrd
customarily	cstmrly
customer	cstmr
cutely	ctly
cuticle	ctcl
cutlet	ctlt
cutover	ctvr
cutting	cttng
cuttingly	cttngly
cyclamen	cyclmn
cycle	cycl
cyclone	cycln
cylinder	cylndr
cymbal	cymbl
cymbals	cymbls
cymosely	cymsly
cynic	cync
cynically	cynclly
cyst	cyst
cytoplasm	cytplsm
daffodil	dffdl
daffodilly	dffdlly
daftly	dftly
daggly	dggly
dahlia	dhl
daisy	dsy
damage	dmg
damageably	dmgbly
damagingly	dmgngly
damnably	dmnbly
damningly	dmnngly
damnously	dmnsly
dancer	dncr
dancing	dncng
dancingly	dncngly
dandically	dndclly
dandilly	dndlly
dandily	dndly
danger	dngr
dangerously	dngrsly
daniel	dnl
dankly	dnkly
dantophily	dntphly
dapperly	dpprly
dare	dr
dark	drk
darkly	drkly
darlingly	drlngly
dart	drt
dartingly	drtngly
dash	dsh
dashboard	dshbrd
dashedly	dshdly
dashingly	dshngly
dastardly	dstrdly
database	dtbs
datably	dtbly
datively	dtvly
daubingly	dbngly
daughter	dghtr
daughterly	dghtrly
dauntingly	dntngly
day	dy
daybed	dybd
dayfly	dyfly
dazedly	dzdly
dazingly	dzngly
deadishly	ddshly
deadlily	ddlly
deadline	ddln
deafeningly	dfnngly
deafly	dfly
deal	dl
dealer	dlr
dearly	drly
death	dth
deathfully	dthflly
deathly	dthly
deathwatch	dthwtch
debasingly	dbsngly
debatefully	dbtflly
debatingly	dbtngly
debauchedly	dbchdly
deboistly	dbstly
debonairly	dbnrly
decadally	dcdlly
decade	dcd
decadently	dcdntly
decanally	dcnlly
decanically	dcnclly
deceitfully	dctflly
deceivably	dcvbly
deceivingly	dcvngly
decemberly	dcmbrly
decennially	dcnnlly
decently	dcntly
deceptiously	dcptsly
deceptively	dcptvly
decidedly	dcddly
decidingly	dcdngly
deciduously	dcdsly
decimal	dcml
decimally	dcmlly
decision	dcsn
decisively	dcsvly
declaredly	dclrdly
declination	dclntn
decorably	dcrbly
decoratively	dcrtvly
decorously	dcrsly
decrease	dcrs
decrepitly	dcrptly
decretorily	dcrtrly
decryption	dcryptn
decursively	dcrsvly
decussately	dcsstly
dedication	ddctn
dedicatorily	ddctrly
deducibly	ddcbly
deductively	ddctvly
deedfully	ddflly
deedily	ddly
deep	dp
deepeningly	dpnngly
defacingly	dfcngly
defamingly	dfmngly
defectively	dfctvly
defense	dfns
defensibly	dfnsbly
defensively	dfnsvly
defiantly	dfntly
deficiently	dfcntly
deficit	dfct
defilingly	dflngly
definably	dfnbly
definedly	dfndly
definition	dfntn
definitively	dfntvly
deformation	dfrmtn
deformedly	dfrmdly
degenerately	dgnrtly
degradedly	dgrddly
deictically	dctclly
deistically	dstclly
dejectedly	djctdly
dejectly	djctly
delayingly	dlyngly
delectably	dlctbly
deliberately	dlbrtly
delicately	dlctly
deliciously	dlcsly
delight	dlght
deliriously	dlrsly
delivery	dlvry
deludingly	dldngly
delusively	dlsvly
demand	dmnd
dementedly	dmntdly
demiheavenly	dmhvnly
demissly	dmssly
demoniacally	dmnclly
demur	dmr
demurely	dmrly
den	dn
denim	dnm
denotatively	dnttvly
densely	dnsly
dentally	dntlly
dentately	dnttly
dentist	dntst
denumerably	dnmrbly
denyingly	dnyngly
deodorant	ddrnt
department	dprtmnt
departure	dprtr
dependably	dpndbly
dependent	dpndnt
deperditely	dprdtly
deplorably	dplrbly
deploredly	dplrdly
deployment	dplymnt
deposit	dpst
depravedly	dprvdly
depression	dprssn
depressive	dprssv
depth	dpth
deputatively	dpttvly
deputy	dpty
derby	drby
derelictly	drlctly
derisively	drsvly
derivably	drvbly
derivately	drvtly
derivatively	drvtvly
derivedly	drvdly
derogately	drgtly
derogatively	drgtvly
derogatorily	drgtrly
derrick	drrck
description	dscrptn
desert	dsrt
desertedly	dsrtdly
deservedly	dsrvdly
design	dsgn
designedly	dsgndly
designer	dsgnr
desirably	dsrbly
desire	dsr
desiredly	dsrdly
desiringly	dsrngly
desirously	dsrsly
desolately	dsltly
despicably	dspcbly
despoticly	dsptcly
dessert	dssrt
destiny	dstny
destitutely	dstttly
destroyer	dstryr
destruction	dstrctn
desultorily	dsltrly
detachably	dtchbly
detachedly	dtchdly
detail	dtl
detailedly	dtldly
detainingly	dtnngly
detainment	dtnmnt
detectably	dtctbly
detective	dtctv
detention	dtntn
determination	dtrmntn
detersively	dtrsvly
detestably	dtstbly
deucedly	dcdly
development	dvlpmnt
deviance	dvnc
devicefully	dvcflly
devil	dvl
devilishly	dvlshly
devily	dvly
deviously	dvsly
devotedly	dvtdly
devotionally	dvtnlly
devouringly	dvrngly
devoutly	dvtly
dew	dw
dexterously	dxtrsly
dextrally	dxtrlly
dhow	dhw
diabolically	dblclly
diadem	ddm
diagonally	dgnlly
dialectally	dlctlly
dialystely	dlystly
diametrally	dmtrlly
dianoetically	dntclly
diaphanously	dphnsly
diaphragm	dphrgm
diarist	drst
diatonically	dtnclly
dibble	dbbl
dickey	dcky
dictaphone	dctphn
diction	dctn
dictionary	dctnry
didascaly	ddscly
dietetically	dttclly
difference	dffrnc
differential	dffrntl
difficulty	dffclty
diffusedly	dffsdly
diffusely	dffsly
diffusibly	dffsbly
diffusively	dffsvly
digestedly	dgstdly
digestibly	dgstbly
digestion	dgstn
digestively	dgstvly
digger	dggr
digital	dgtl
digitally	dgtlly
digitately	dgttly
dignifiedly	dgnfdly
dignity	dgnty
dilapidation	dlpdtn
dilatably	dltbly
dilatingly	dltngly
dilatorily	dltrly
diligently	dlgntly
dill	dll
dilutedly	dltdly
dilutely	dltly
dime	dm
dimension	dmnsn
dimly	dmly
dimple	dmpl
diner	dnr
dinghy	dnghy
dingily	dngly
dinner	dnnr
dinnerly	dnnrly
dinosaur	dnsr
dinosaurs	dnsrs
dioeciously	dcsly
diploma	dplm
dipstick	dpstck
direction	drctn
directively	drctvly
directly	drctly
director	drctr
direfully	drflly
dirndl	drndl
disadvantage	dsdvntg
disagreeably	dsgrbly
disally	dslly
disarmament	dsrmmnt
disaster	dsstr
disavowedly	dsvwdly
discipline	dscpln
disco	dsc
discount	dscnt
discovery	dscvry
discreetly	dscrtly
discussion	dscssn
disdainly	dsdnly
disease	dss
diseasedly	dssdly
disguise	dsgs
disguisedly	dsgsdly
disgust	dsgst
dishes	dshs
dishwasher	dshwshr
disjointly	dsjntly
disk	dsk
disloyally	dslylly
dismally	dsmlly
disorderly	dsrdrly
disparately	dsprtly
dispiteously	dsptsly
display	dsply
disposedly	dspsdly
disposer	dspsr
disputably	dsptbly
disquietedly	dsqtdly
disquietly	dsqtly
dissembly	dssmbly
dissolutely	dssltly
dissuasively	dsssvly
distally	dstlly
distance	dstnc
distantly	dstntly
distribution	dstrbtn
distributor	dstrbtr
district	dstrct
diuretically	drtclly
diurnally	drnlly
divan	dvn
divaricately	dvrctly
diver	dvr
diversly	dvrsly
divertedly	dvrtdly
divide	dvd
dividedly	dvddly
divider	dvdr
dividingly	dvdngly
dividually	dvdlly
divinely	dvnly
diving	dvng
diviningly	dvnngly
divisibly	dvsbly
division	dvsn
divisionally	dvsnlly
divisively	dvsvly
dizzily	dzzly
docetically	dctclly
dock	dck
doctor	dctr
doctorially	dctrlly
doctorly	dctrly
document	dcmnt
dodgily	ddgly
doggedly	dggdly
doggishly	dggshly
dogly	dgly
dogs	dgs
dogsled	dgsld
dogwood	dgwd
dolefully	dlflly
dolently	dlntly
dolesomely	dlsmly
dollar	dllr
dollishly	dllshly
dolls	dlls
dolman	dlmn
dolphin	dlphn
doltishly	dltshly
domain	dmn
dominantly	dmnntly
donatively	dntvly
donkey	dnky
doorknob	drknb
doorpost	drpst
dorsally	drslly
dory	dry
dot	dt
dotardly	dtrdly
dotingly	dtngly
dottily	dttly
double	dbl
doubling	dblng
doubly	dbly
doubt	dbt
doubtably	dbtbly
doubtedly	dbtdly
doubter	dbtr
doucely	dcly
doughtily	dghtly
dowdily	dwdly
dowily	dwly
downforce	dwnfrc
downgrade	dwngrd
downily	dwnly
downtown	dwntwn
dozily	dzly
drably	drbly
draft	drft
draftily	drftly
drag	drg
draggily	drggly
dragon	drgn
dragonfly	drgnfly
dragster	drgstr
drain	drn
drama	drm
dramaturge	drmtrg
draw	drw
drawbridge	drwbrdg
drawer	drwr
drawing	drwng
drawly	drwly
dreadfully	drdflly
dreadingly	drdngly
dreadly	drdly
dreamfully	drmflly
dreamily	drmly
dreamingly	drmngly
dreamsily	drmsly
drearfully	drrflly
drearily	drrly
dredger	drdgr
dress	drss
dresser	drssr
dressily	drssly
dressing	drssng
drill	drll
drink	drnk
drinkably	drnkbly
drive	drv
driver	drvr
driveway	drvwy
driving	drvng
drivingly	drvngly
drizzle	drzzl
drizzly	drzzly
dromedary	drmdry
dronishly	drnshly
droopingly	drpngly
drop	drp
drowsily	drwsly
drubbly	drbbly
drummer	drmmr
drunkenly	drnknly
dryer	dryr
dryly	dryly
dubiously	dbsly
dubitatively	dbttvly
duckling	dcklng
ducks	dcks
ductilely	dctlly
dud	dd
duffel	dffl
dugout	dgt
dukely	dkly
dulcimer	dlcmr
dulwilly	dlwlly
duly	dly
dumbly	dmbly
dumbwaiter	dmbwtr
dump	dmp
dumpily	dmply
dumpishly	dmpshly
duncishly	dncshly
dune buggy	dn bggy
dungarees	dngrs
dungeon	dngn
dunghilly	dnghlly
duodecimally	ddcmlly
duopoly	dply
duplexer	dplxr
duringly	drngly
duskishly	dskshly
duskly	dskly
dust	dst
duster	dstr
dustily	dstly
duteously	dtsly
dutifully	dtflly
duty	dty
dwarf	dwrf
dwelling	dwllng
dyingly	dyngly
dynamo	dynm
e-book	-bk
e-reader	-rdr
eardrum	rdrm
earmuffs	rmffs
earnestly	rnstly
earplug	rplg
earrings	rrngs
earth	rth
earthquake	rthqk
earthworm	rthwrm
ease	s
easefully	sflly
east	st
eastwardly	stwrdly
eave	v
eavesdropper	vsdrppr
ebulliently	bllntly
ecclesia	ccls
eclipse	clps
ecliptic	clptc
ecologically	clgclly
economically	cnmclly
economics	cnmcs
economy	cnmy
ectally	ctlly
ectosteally	ctstlly
ecumenically	cmnclly
ecumenist	cmnst
eddy	ddy
edge	dg
edger	dgr
edgingly	dgngly
edifyingly	dfyngly
editor	dtr
editorial	dtrl
educationally	dctnlly
edward	dwrd
eel	l
effacement	ffcmnt
effective	ffctv
effectively	ffctvly
effectually	ffctlly
effeminately	ffmntly
efficaciously	ffccsly
efficacy	ffccy
efficiency	ffcncy
efficiently	ffcntly
effort	ffrt
effusively	ffsvly
egg	gg
egghead	gghd
eggnog	ggng
eggplant	ggplnt
eggs	ggs
egoistically	gstclly
egregiously	grgsly
eidently	dntly
eight	ght
eighthly	ghthly
ejectively	jctvly
ejector	jctr
elaborately	lbrtly
elastically	lstclly
elatedly	ltdly
elbow	lbw
elderly	ldrly
electively	lctvly
electorally	lctrlly
electricity	lctrcty
elegantly	lgntly
element	lmnt
elementally	lmntlly
elementarily	lmntrly
elephant	lphnt
elevatedly	lvtdly
elevatingly	lvtngly
elevator	lvtr
eleventhly	lvnthly
elfishly	lfshly
eligibly	lgbly
elixir	lxr
ellipse	llps
elm	lm
elongation	lngtn
eloquently	lqntly
elusively	lsvly
elvishly	lvshly
emanatively	mntvly
emboly	mbly
embossing	mbssng
embraceably	mbrcbly
emergence	mrgnc
emergency	mrgncy
emergent	mrgnt
emergently	mrgntly
emery	mry
emetically	mtclly
eminently	mnntly
emotionally	mtnlly
emotively	mtvly
empanoply	mpnply
emphasis	mphss
employee	mply
employer	mplyr
employment	mplymnt
empowerment	mpwrmnt
emptily	mptly
emu	m
emulatively	mltvly
emulously	mlsly
encyclopedia	ncyclpd
end	nd
endearedly	ndrdly
endemically	ndmclly
endosteally	ndstlly
endothelium	ndthlm
endurably	ndrbly
enduringly	ndrngly
enemy	nmy
energy	nrgy
enforcedly	nfrcdly
engagedly	nggdly
engagingly	nggngly
engine	ngn
engineer	ngnr
engineering	ngnrng
englacially	nglclly
englishly	nglshly
enigma	ngm
enjelly	njlly
enjoyably	njybly
enjoyingly	njyngly
enjoyment	njymnt
enlargedly	nlrgdly
enodally	ndlly
enormously	nrmsly
enquiry	nqry
enragedly	nrgdly
enteromegaly	ntrmgly
enthusiasm	nthssm
enticingly	ntcngly
entitatively	ntttvly
entomophily	ntmphly
entrance	ntrnc
entry	ntry
enunciatively	nnctvly
enviably	nvbly
enviously	nvsly
environment	nvrnmnt
envy	nvy
envyingly	nvyngly
epauliere	plr
epaxially	pxlly
ephemera	phmr
ephemerally	phmrlly
ephemeris	phmrs
epiboly	pbly
epically	pclly
epicly	pcly
epicurishly	pcrshly
epidemically	pdmclly
episcopally	pscplly
episodically	psdclly
epistolarily	pstlrly
epitomically	ptmclly
epochally	pchlly
eponym	pnym
epoxy	pxy
equably	qbly
equally	qlly
equanimously	qnmsly
equationally	qtnlly
equatorially	qtrlly
equilaterally	qltrlly
equinely	qnly
equinoctially	qnctlly
equinox	qnx
equinumerally	qnmrlly
equipment	qpmnt
equivalent	qvlnt
equivalently	qvlntly
equivocally	qvclly
erotically	rtclly
erratically	rrtclly
erroneously	rrnsly
error	rrr
eruptively	rptvly
escape	scp
escapingly	scpngly
espadrille	spdrll
espalier	splr
essay	ssy
essentially	ssntlly
estate	stt
estimably	stmbly
estimate	stmt
estrogen	strgn
estuary	stry
esuriently	srntly
eternally	trnlly
ethernet	thrnt
ethically	thclly
ethics	thcs
ethnically	thnclly
etiologically	tlgclly
eugenically	gnclly
euphemiously	phmsly
euphonically	phnclly
euphoniously	phnsly
euphonium	phnm
eurocentrism	rcntrsm
europeanly	rpnly
evadingly	vdngly
evaluator	vltr
evasively	vsvly
evening	vnng
evening-wear	vnng-wr
evenly	vnly
event	vnt
eventfully	vntflly
eventually	vntlly
eviction	vctn
evidence	vdnc
evidentially	vdntlly
evidently	vdntly
evincibly	vncbly
evincingly	vncngly
evolution	vltn
ex-husband	x-hsbnd
ex-wife	x-wf
exactly	xctly
exaltedly	xltdly
exam	xm
examination	xmntn
examiner	xmnr
examiningly	xmnngly
example	xmpl
exceedingly	xcdngly
exceptively	xcptvly
excessively	xcssvly
exchange	xchng
excitedly	xctdly
excitement	xctmnt
excitingly	xctngly
exclamation	xclmtn
exclusively	xclsvly
excursively	xcrsvly
excusably	xcsbly
excuse	xcs
excusefully	xcsflly
excusingly	xcsngly
execrably	xcrbly
execratively	xcrtvly
executively	xctvly
executor	xctr
exegetically	xgtclly
exemplarily	xmplrly
exercise	xrcs
exhaust	xhst
exhaustedly	xhstdly
exhaustively	xhstvly
exhibitively	xhbtvly
exigently	xgntly
exiguously	xgsly
exile	xl
eximiously	xmsly
existence	xstnc
existently	xstntly
exit	xt
exogenously	xgnsly
exoterically	xtrclly
expandedly	xpnddly
expansibly	xpnsbly
expansion	xpnsn
expansionism	xpnsnsm
expansively	xpnsvly
expectedly	xpctdly
expediently	xpdntly
expeditely	xpdtly
expeditiously	xpdtsly
experience	xprnc
expert	xprt
expertly	xprtly
expiringly	xprngly
explanation	xplntn
expletively	xpltvly
explicitly	xplctly
explosively	xplsvly
exposition	xpstn
expositively	xpstvly
expositorily	xpstrly
expression	xprssn
expressly	xprssly
exquisitely	xqstly
exquisitively	xqstvly
extendedly	xtnddly
extension	xtnsn
extensively	xtnsvly
extent	xtnt
exteriorly	xtrrly
external	xtrnl
externally	xtrnlly
extorsively	xtrsvly
extraneously	xtrnsly
extreme	xtrm
extremely	xtrmly
extricably	xtrcbly
extrorsely	xtrrsly
exuberantly	xbrntly
exultantly	xltntly
exultingly	xltngly
eyeball	ybll
eyebrow	ybrw
eyebrows	ybrws
eyeglasses	yglsss
eyelash	ylsh
eyelashes	ylshs
eyelid	yld
eyelids	ylds
eyeliner	ylnr
eyes	ys
eyestrain	ystrn
fabulously	fblsly
face	fc
facelift	fclft
facetely	fctly
facetiously	fctsly
facilely	fclly
facilities	fclts
facingly	fcngly
facsimile	fcsml
factitively	fcttvly
factor	fctr
factorially	fctrlly
factory	fctry
factually	fctlly
faculty	fclty
fadedly	fddly
fadingly	fdngly
faggingly	fggngly
fahrenheit	fhrnht
faintingly	fntngly
faintly	fntly
fairies	frs
faith	fth
faithfully	fthflly
fallaciously	fllcsly
fallibly	fllbly
falling-out	fllng-t
famelessly	fmlssly
familiar	fmlr
familiarly	fmlrly
family	fmly
famously	fmsly
fanatically	fntclly
fancifully	fncflly
fang	fng
fanlight	fnlght
farcically	frcclly
farinaceously	frncsly
farinosely	frnsly
farrandly	frrndly
farrantly	frrntly
fascia	fsc
fasciately	fsctly
fashionably	fshnbly
fastidiously	fstdsly
fastingly	fstngly
fastuously	fstsly
fatherly	fthrly
fatidically	ftdclly
fatigues	ftgs
fatiguingly	ftgngly
fatuously	ftsly
faucet	fct
faultfully	fltflly
faunally	fnlly
favorably	fvrbly
favoredly	fvrdly
favoringly	fvrngly
favosely	fvsly
fawn	fwn
fawningly	fwnngly
fearedly	frdly
fearfully	frflly
fearingly	frngly
fearlessly	frlssly
fearsomely	frsmly
feast	fst
feastfully	fstflly
feather	fthr
featurally	ftrlly
featurely	ftrly
feckfully	fckflly
feckly	fckly
fedelini	fdln
federally	fdrlly
federatively	fdrtvly
fedora	fdr
fee	f
feebly	fbly
feedback	fdbck
feeling	flng
feelingly	flngly
feignedly	fgndly
feigningly	fgnngly
felicitously	flctsly
felinely	flnly
feloniously	flnsly
felony	flny
female	fml
femalely	fmlly
femininely	fmnnly
fence	fnc
fencing	fncng
fender	fndr
ferinely	frnly
ferociously	frcsly
ferry	frry
ferryboat	frrybt
fertilely	frtlly
fertilizer	frtlzr
fervently	frvntly
fervidly	frvdly
fessely	fssly
festally	fstlly
festinately	fstntly
festivally	fstvlly
festively	fstvly
fetidly	ftdly
feudally	fdlly
feverishly	fvrshly
feverously	fvrsly
few	fw
fiber	fbr
fiberglass	fbrglss
fibrously	fbrsly
fiction	fctn
fictionally	fctnlly
fictitiously	fcttsly
fictively	fctvly
fiddle	fddl
fidgetily	fdgtly
fiducially	fdclly
fiduciarily	fdcrly
fiendfully	fndflly
fiendishly	fndshly
fiendly	fndly
fiercely	frcly
fifth	ffth
fifthly	ffthly
fight	fght
fighter	fghtr
figurately	fgrtly
figuratively	fgrtvly
figure	fgr
figuredly	fgrdly
figurine	fgrn
filially	fllly
fill	fll
fillingly	fllngly
filly	flly
filmily	flmly
filth	flth
filthily	flthly
final	fnl
finance	fnnc
financially	fnnclly
find	fnd
finding	fndng
fine	fn
finely	fnly
finger	fngr
fingernail	fngrnl
finically	fnclly
finickily	fnckly
finish	fnsh
finisher	fnshr
fir	fr
firefly	frfly
fireman	frmn
fireplace	frplc
firewall	frwll
firmly	frmly
fiscally	fsclly
fish	fsh
fishbone	fshbn
fisherman	fshrmn
fishery	fshry
fishily	fshly
fishing	fshng
fishingly	fshngly
fishmonger	fshmngr
fishnet	fshnt
fisting	fstng
fitfully	ftflly
fitly	ftly
fittily	fttly
fittingly	fttngly
fixedly	fxdly
fixture	fxtr
flabbily	flbbly
flaccidly	flccdly
flag	flg
flaggily	flggly
flagitiously	flgtsly
flakily	flkly
flame	flm
flamingly	flmngly
flanker	flnkr
flannelly	flnnlly
flaringly	flrngly
flash	flsh
flashily	flshly
flat	flt
flatboat	fltbt
flatly	fltly
flauntily	flntly
flavor	flvr
flax	flx
fleck	flck
fleece	flc
fleecily	flcly
fleshlily	flshlly
flexuously	flxsly
fleyedly	flydly
flight	flght
flightily	flghtly
flimsily	flmsly
flintlock	flntlck
floatingly	fltngly
floccosely	flccsly
flood	fld
floor	flr
floozie	flz
floppily	flpply
florally	flrlly
floridly	flrdly
flow	flw
flower	flwr
flowerily	flwrly
flowers	flwrs
flowingly	flwngly
flu	fl
fluffily	flffly
flugelhorn	flglhrn
fluidally	fldlly
fluidly	fldly
fluke	flk
flurriedly	flrrdly
fluxibly	flxbly
fluxionally	flxnlly
fly	fly
flyingly	flyngly
flytrap	flytrp
foam	fm
foamingly	fmngly
fob	fb
focus	fcs
fog	fg
foggily	fggly
foiningly	fnngly
foldedly	flddly
folder	fldr
foliously	flsly
following	fllwng
font	fnt
fontally	fntlly
food	fd
foolhardily	flhrdly
foot	ft
foot-rest	ft-rst
football	ftbll
footingly	ftngly
footnote	ftnt
footrest	ftrst
footstool	ftstl
foppishly	fppshly
foray	fry
force	frc
forcedly	frcdly
forcefully	frcflly
forcibly	frcbly
forcingly	frcngly
forearm	frrm
forebear	frbr
forecast	frcst
forehead	frhd
foreignly	frgnly
foremostly	frmstly
foreseeingly	frsngly
forest	frst
forestry	frstry
forever	frvr
forgery	frgry
forgivably	frgvbly
fork	frk
forkedly	frkdly
forlornly	frlrnly
formably	frmbly
formal	frml
formally	frmlly
format	frmt
formatively	frmtvly
former	frmr
formerly	frmrly
formidably	frmdbly
forsakenly	frsknly
fortnight	frtnght
fortress	frtrss
fortuitously	frttsly
fortunately	frtntly
fortune	frtn
forum	frm
foundation	fndtn
fountain	fntn
fountainously	fntnsly
foursquarely	frsqrly
fowl	fwl
fox	fx
foxglove	fxglv
foxily	fxly
frabjously	frbjsly
fractiously	frctsly
fragilely	frglly
fragrance	frgrnc
frailly	frlly
frankly	frnkly
franticly	frntcly
fratricide	frtrcd
fraudfully	frdflly
fraudster	frdstr
frayedly	frydly
frazzle	frzzl
freakily	frkly
freakishly	frkshly
freckle	frckl
freckly	frckly
freedom	frdm
freely	frly
freeplay	frply
freeze	frz
freezer	frzr
freezingly	frzngly
freight	frght
freighter	frghtr
fremdly	frmdly
frenchily	frnchly
frenziedly	frnzdly
freon	frn
frequently	frqntly
fresco	frsc
freshly	frshly
friarly	frrly
friction	frctn
fridge	frdg
friend	frnd
friendlily	frndlly
friendly	frndly
friends	frnds
friendship	frndshp
frigate	frgt
frigidly	frgdly
frillily	frllly
fringe	frng
friskily	frskly
frivolously	frvlsly
frizzly	frzzly
frock	frck
frog	frg
frogs	frgs
frolicly	frlcly
frondosely	frndsly
front	frnt
frontally	frntlly
frostily	frstly
frothily	frthly
frowardly	frwrdly
frown	frwn
frowstily	frwstly
frowzly	frwzly
frozenly	frznly
fruit	frt
fruitfully	frtflly
frumpily	frmply
frustration	frstrtn
fugaciously	fgcsly
fugally	fglly
fugitively	fgtvly
fulgently	flgntly
fuliginously	flgnsly
fulsomely	flsmly
function	fnctn
fundraising	fndrsng
funeral	fnrl
funereally	fnrlly
funnily	fnnly
funny	fnny
furcately	frctly
furiously	frsly
furnace	frnc
furniture	frntr
furtherly	frthrly
furtively	frtvly
fusarium	fsrm
fusibly	fsbly
fusilly	fslly
fustily	fstly
futilely	ftlly
futon	ftn
future	ftr
fuzzily	fzzly
gaddingly	gddngly
gadfly	gdfly
gaffer	gffr
gainfully	gnflly
gainly	gnly
gaiters	gtrs
gale	gl
gallantly	gllntly
gallery	gllry
gallfly	gllfly
galliardly	gllrdly
gallingly	gllngly
gallon	glln
galoshes	glshs
gamebird	gmbrd
gamesomely	gmsmly
gametically	gmtclly
gamma-ray	gmm-ry
gamostely	gmstly
gander	gndr
gangly	gngly
gap	gp
gapingly	gpngly
garb	grb
garbage	grbg
garden	grdn
garlic	grlc
garrulously	grrlsly
garter	grtr
gasoline	gsln
gaspingly	gspngly
gastropod	gstrpd
gate	gt
gateway	gtwy
gather	gthr
gauchely	gchly
gauntlet	gntlt
gauzily	gzly
gawkily	gwkly
gawkishly	gwkshly
gazebo	gzb
gazelle	gzll
gazingly	gzngly
gear	gr
gearshift	grshft
geese	gs
gelidly	gldly
gem	gm
geminately	gmntly
gemmily	gmmly
gemsbok	gmsbk
gene	gn
general	gnrl
generally	gnrlly
generatively	gnrtvly
generically	gnrclly
generously	gnrsly
genetically	gntclly
genetics	gntcs
genially	gnlly
geniculately	gncltly
genitivally	gntvlly
genteelly	gntlly
gently	gntly
genuinely	gnnly
geodetically	gdtclly
geography	ggrphy
geologically	glgclly
geology	glgy
geomaly	gmly
geometry	gmtry
george	grg
geranium	grnm
gerbil	grbl
germanely	grmnly
germanly	grmnly
germinally	grmnlly
gerundially	grndlly
gerundively	grndvly
geyser	gysr
ghastily	ghstly
gherkin	ghrkn
ghost	ghst
ghostlily	ghstlly
ghoulishly	ghlshly
giants	gnts
gibbously	gbbsly
gibingly	gbngly
giddily	gddly
gift	gft
giftedly	gftdly
gigantism	ggntsm
giggly	gggly
gingerly	gngrly
ginseng	gnsng
giraffe	grff
girdingly	grdngly
girdle	grdl
girl	grl
girlfriend	grlfrnd
girlfully	grlflly
girlishly	grlshly
girls	grls
girly	grly
give	gv
glacially	glclly
gladfully	gldflly
gladiolus	gldls
gladsomely	gldsmly
glamorously	glmrsly
gland	glnd
glarily	glrly
glaringly	glrngly
glass	glss
glasses	glsss
glaucously	glcsly
glazily	glzly
gleamily	glmly
gleeishly	glshly
gleesomely	glsmly
glegly	glgly
glen	gln
glibly	glbly
glider	gldr
gliding	gldng
glidingly	gldngly
gloatingly	gltngly
globally	glblly
globosely	glbsly
globularly	glblrly
gloomfully	glmflly
gloomingly	glmngly
gloriously	glrsly
glossily	glssly
glossolaly	glsslly
glove	glv
gloves	glvs
glowfly	glwfly
glowingly	glwngly
glozingly	glzngly
glumpily	glmply
glutinously	gltnsly
gnarly	gnrly
gnawingly	gnwngly
gnomically	gnmclly
go-kart	g-krt
goatishly	gtshly
goatly	gtly
gobbler	gbblr
godlessly	gdlssly
godlily	gdlly
godmother	gdmthr
goggles	gggls
gold	gld
goldenly	gldnly
goldfish	gldfsh
golf	glf
gondola	gndl
gong	gng
good	gd
good-bye	gd-by
goodbye	gdby
goofily	gfly
googly	ggly
goosishly	gsshly
gopher	gphr
gorbelly	grblly
gore-tex	gr-tx
gorfly	grfly
gorgedly	grgdly
gosling	gslng
gospelly	gsplly
gossip	gssp
gothically	gthclly
governably	gvrnbly
governance	gvrnnc
government	gvrnmnt
governor	gvrnr
gowkedly	gwkdly
gown	gwn
grab-bag	grb-bg
gracefully	grcflly
graciously	grcsly
gradatively	grdtvly
gradely	grdly
gradually	grdlly
gram	grm
grammar	grmmr
grandiosely	grndsly
grandly	grndly
grandmom	grndmm
grandson	grndsn
granny	grnny
grantedly	grntdly
granularly	grnlrly
grapefruit	grpfrt
graph	grph
graphic	grphc
graphicly	grphcly
grass	grss
grassland	grsslnd
gratefully	grtflly
gratifiedly	grtfdly
gratitude	grttd
gratuitously	grttsly
gravelly	grvlly
gravely	grvly
grayfly	gryfly
grazingly	grzngly
great	grt
greatly	grtly
greek	grk
green	grn
greenhouse	grnhs
greenly	grnly
greetingly	grtngly
gregariously	grgrsly
grenade	grnd
grenadierly	grndrly
grey	gry
greyly	gryly
grief	grf
grieffully	grfflly
grievedly	grvdly
grievingly	grvngly
grievously	grvsly
grill	grll
grisly	grsly
gristly	grstly
grittily	grttly
grizzly	grzzly
groaningly	grnngly
grocerly	grcrly
grocery	grcry
groggily	grggly
groomishly	grmshly
gropingly	grpngly
grossly	grssly
grotesquely	grtsqly
grouchily	grchly
groundably	grndbly
groundedly	grnddly
group	grp
grouper	grpr
grouse	grs
growingly	grwngly
growly	grwly
growth	grwth
grubbily	grbbly
gruelly	grlly
gruesomely	grsmly
gruffly	grffly
grumbly	grmbly
grumly	grmly
grumpily	grmply
guarantee	grnt
guard	grd
guardedly	grddly
guardfully	grdflly
guardianly	grdnly
guess	gss
guessingly	gssngly
guest	gst
guestbook	gstbk
guidance	gdnc
guidwilly	gdwlly
guilefully	glflly
guilelessly	gllssly
guilt	glt
guiltily	gltly
guilty	glty
guitar	gtr
guitarist	gtrst
gullibly	gllbly
gullishly	gllshly
gulpingly	glpngly
gumshoes	gmshs
gurgly	grgly
gushily	gshly
gushingly	gshngly
gustfully	gstflly
gutter	gttr
gutturally	gttrlly
guy	gy
gwely	gwly
gym	gym
gymnast	gymnst
gynaecology	gynclgy
gyrally	gyrlly
gyro	gyr
gyroidally	gyrdlly
habit	hbt
habitably	hbtbly
habitually	hbtlly
hacienda	hcnd
hackingly	hckngly
hackly	hckly
hacksaw	hcksw
hackwork	hckwrk
haggardly	hggrdly
haggishly	hggshly
haggly	hggly
hail	hl
haily	hly
haircut	hrct
half	hlf
halibut	hlbt
halieutically	hltclly
hallowedly	hllwdly
hallway	hllwy
haltingly	hltngly
hamaki	hmk
hamburger	hmbrgr
hammer	hmmr
hammock	hmmck
hamperedly	hmprdly
hamster	hmstr
hand	hnd
handball	hndbll
handicap	hndcp
handle	hndl
handlebar	hndlbr
handmaiden	hndmdn
hands	hnds
handsaw	hndsw
handsomely	hndsmly
hang	hng
hangingly	hngngly
haplessly	hplssly
haplolaly	hpllly
haply	hply
happily	hpply
happiness	hppnss
harassedly	hrssdly
harbour	hrbr
hard-hat	hrd-ht
hardboard	hrdbrd
hardcover	hrdcvr
hardening	hrdnng
hardhat	hrdht
hardily	hrdly
hardware	hrdwr
harm	hrm
harmfully	hrmflly
harmonica	hrmnc
harmoniously	hrmnsly
harmony	hrmny
harp	hrp
harpooner	hrpnr
harshly	hrshly
hassock	hssck
hastately	hsttly
hastefully	hstflly
hastily	hstly
hatbox	htbx
hatchet	htcht
hate	ht
hatefully	htflly
hatred	htrd
haughtly	hghtly
haversack	hvrsck
hawk	hwk
hay	hy
hazardously	hzrdsly
hazelly	hzlly
hazily	hzly
head	hd
headily	hdly
headlight	hdlght
headline	hdln
headlongly	hdlngly
headrest	hdrst
healingly	hlngly
health	hlth
healthily	hlthly
hearing	hrng
heartache	hrtch
heartedly	hrtdly
heartfully	hrtflly
hearth	hrth
hearthside	hrthsd
heartily	hrtly
heartsomely	hrtsmly
heartwood	hrtwd
heatedly	htdly
heater	htr
heatingly	htngly
heaven	hvn
heavenishly	hvnshly
heavenly	hvnly
heavily	hvly
heavy	hvy
hebraically	hbrclly
hectically	hctclly
hecticly	hctcly
hectorly	hctrly
hederaceously	hdrcsly
hedge	hdg
hedgehog	hdghg
hedgingly	hdgngly
hedonically	hdnclly
heedfully	hdflly
heedlessly	hdlssly
heftily	hftly
height	hght
heinously	hnsly
heirloom	hrlm
helen	hln
heliacally	hlclly
helicoidally	hlcdlly
helicopter	hlcptr
helium	hlm
hell	hll
hellcat	hllct
hellishly	hllshly
helmet	hlmt
help	hlp
helpfully	hlpflly
helpingly	hlpngly
helply	hlply
hemimetaboly	hmmtbly
hemp	hmp
hen	hn
hendly	hndly
hepatomegaly	hptmgly
herb	hrb
herbaceously	hrbcsly
hereditably	hrdtbly
hereditarily	hrdtrly
heretically	hrtclly
heritably	hrtbly
heroically	hrclly
heroicly	hrcly
herring	hrrng
hesitantly	hstntly
hesitatively	hsttvly
heterically	htrclly
heterodoxly	htrdxly
heteroeciously	htrcsly
heteropoly	htrply
hetterly	httrly
hexagon	hxgn
hexagonally	hxgnlly
heyday	hydy
hiddenly	hddnly
hideously	hdsly
high	hgh
high-rise	hgh-rs
highlight	hghlght
highly	hghly
highway	hghwy
hilariously	hlrsly
hillbilly	hllblly
hinderly	hndrly
hintingly	hntngly
hippodrome	hppdrm
hippopotamus	hppptms
hissingly	hssngly
history	hstry
hitchily	htchly
hive	hv
hobbies	hbbs
hobbit	hbbt
hobby	hbby
hockey	hcky
hoe	h
hog	hg
hold	hld
holdingly	hldngly
holiday	hldy
holily	hlly
hollowly	hllwly
holly	hlly
holometaboly	hlmtbly
home	hm
homelessly	hmlssly
homelily	hmlly
homely	hmly
homerically	hmrclly
homesickly	hmsckly
homewardly	hmwrdly
homework	hmwrk
homicidally	hmcdlly
homogenate	hmgnt
homogonously	hmgnsly
homonym	hmnym
homophyly	hmphyly
homostyly	hmstyly
homotaxially	hmtxlly
homotonously	hmtnsly
honestly	hnstly
honesty	hnsty
honey	hny
honeybee	hnyb
honeyedly	hnydly
honily	hnly
honorably	hnrbly
honorarily	hnrrly
honoree	hnr
hoof	hf
hook	hk
hope	hp
hopefully	hpflly
hopingly	hpngly
hoppingly	hppngly
hops	hps
horn	hrn
hornet	hrnt
hornily	hrnly
horribly	hrrbly
horridly	hrrdly
horror	hrrr
horse	hrs
horsefly	hrsfly
horses	hrss
horsily	hrsly
hortatively	hrttvly
hortatorily	hrttrly
hosiery	hsry
hospice	hspc
hospitably	hsptbly
hospital	hsptl
hospitality	hsptlty
host	hst
hostel	hstl
hostess	hstss
hostilely	hstlly
hot-dog	ht-dg
hotel	htl
hotheadedly	hthddly
hotly	htly
hour	hr
hourglass	hrglss
hourly	hrly
house	hs
houseboat	hsbt
housefly	hsfly
housekeeperly	hskprly
housemaidenly	hsmdnly
houses	hss
housewifely	hswfly
housework	hswrk
housing	hsng
hovel	hvl
hovercraft	hvrcrft
hoveringly	hvrngly
hoverly	hvrly
howitzer	hwtzr
howlingly	hwlngly
hub	hb
hubbly	hbbly
hubcap	hbcp
huffily	hffly
huffingly	hffngly
huffishly	hffshly
hugely	hgly
hugeously	hgsly
hugger	hggr
huggingly	hggngly
human	hmn
humanly	hmnly
humbly	hmbly
humidity	hmdty
humidly	hmdly
humoresquely	hmrsqly
humorously	hmrsly
humorsomely	hmrsmly
humour	hmr
hunger	hngr
hungerly	hngrly
hunt	hnt
huntedly	hntdly
hurdler	hrdlr
hurricane	hrrcn
hurry	hrry
hurt	hrt
husband	hsbnd
husbandly	hsbndly
hushedly	hshdly
hushfully	hshflly
hushingly	hshngly
huskily	hskly
hutch	htch
hyacinth	hycnth
hydrant	hydrnt
hydraulics	hydrlcs
hydrofoil	hydrfl
hydrogen	hydrgn
hyena	hyn
hygienic	hygnc
hymeneally	hymnlly
hyostyly	hystyly
hypertely	hyprtly
hyphenation	hyphntn
hypopetaly	hypptly
hypothermia	hypthrm
iambically	mbclly
ice	c
ice-cream	c-crm
icebreaker	cbrkr
icecream	ccrm
icicle	ccl
icily	cly
iconoduly	cndly
iconophily	cnphly
ideally	dlly
ideationally	dtnlly
ideologically	dlgclly
idiomatically	dmtclly
idiotically	dtclly
ignobly	gnbly
ignominiously	gnmnsly
ignorantly	gnrntly
ikebana	kbn
illatively	lltvly
illaudably	lldbly
illegal	llgl
illegally	llglly
illegibly	llgbly
illiberally	llbrlly
illicitly	llctly
illimitably	llmtbly
illimitedly	llmtdly
illiquidly	llqdly
illiterately	lltrtly
illocally	llclly
illogically	llgclly
illudedly	llddly
illusorily	llsrly
image	mg
imagerially	mgrlly
imaginably	mgnbly
imaginarily	mgnrly
imagination	mgntn
imaginatively	mgntvly
imbricately	mbrctly
imitatively	mttvly
immaculately	mmcltly
immanely	mmnly
immaterially	mmtrlly
immaturely	mmtrly
immeasurably	mmsrbly
immediately	mmdtly
immedicably	mmdcbly
immemorially	mmmrlly
immensely	mmnsly
imminently	mmnntly
immiscibly	mmscbly
immitigably	mmtgbly
immoderately	mmdrtly
immodestly	mmdstly
immortally	mmrtlly
immovably	mmvbly
immusically	mmsclly
immutably	mmtbly
impact	mpct
impalpably	mplpbly
impartially	mprtlly
impassively	mpssvly
impatiently	mptntly
impavidly	mpvdly
impeccably	mpccbly
impecuniously	mpcnsly
impedingly	mpdngly
imperatively	mprtvly
imperially	mprlly
imperiously	mprsly
impermeably	mprmbly
imperviously	mprvsly
impetuously	mptsly
impiously	mpsly
impishly	mpshly
implacably	mplcbly
implausibly	mplsbly
implement	mplmnt
implicitly	mplctly
impliedly	mpldly
impolitely	mpltly
impoliticly	mpltcly
impopularly	mpplrly
importably	mprtbly
importance	mprtnc
importunely	mprtnly
imposingly	mpsngly
impossibly	mpssbly
imprecisely	mprcsly
impress	mprss
impression	mprssn
improbably	mprbbly
improperly	mprprly
improvably	mprvbly
improvement	mprvmnt
impudence	mpdnc
impudently	mpdntly
impulse	mpls
impulsively	mplsvly
impunely	mpnly
impunibly	mpnbly
impurely	mprly
imputably	mptbly
imputatively	mpttvly
imputedly	mptdly
in-joke	n-jk
in-laws	n-lws
inactively	nctvly
inadequately	ndqtly
inadequatively	ndqtvly
inadvisedly	ndvsdly
inanimately	nnmtly
inappositely	nppstly
inarguably	nrgbly
inaudibly	ndbly
inbox	nbx
incedingly	ncdngly
incentively	ncntvly
inceptively	ncptvly
incessably	ncssbly
incestuously	ncstsly
inchoately	nchtly
incident	ncdnt
incidently	ncdntly
incipiently	ncpntly
incisively	ncsvly
incitingly	nctngly
inclusively	nclsvly
income	ncm
incourteously	ncrtsly
increase	ncrs
increasedly	ncrsdly
increately	ncrtly
inculpably	nclpbly
indecently	ndcntly
indecisively	ndcsvly
indefeasibly	ndfsbly
indefinably	ndfnbly
indefinitely	ndfntly
indelibly	ndlbly
indelicately	ndlctly
indentedly	ndntdly
independence	ndpndnc
independent	ndpndnt
index	ndx
indexically	ndxclly
indication	ndctn
indictably	ndctbly
indigence	ndgnc
indigenously	ndgnsly
indigently	ndgntly
indignly	ndgnly
individual	ndvdl
individually	ndvdlly
indolently	ndlntly
indomitably	ndmtbly
indubiously	ndbsly
inducedly	ndcdly
inductively	ndctvly
industry	ndstry
ineligibly	nlgbly
ineloquently	nlqntly
ineluctably	nlctbly
ineptly	nptly
inequitably	nqtbly
inerasably	nrsbly
inerrably	nrrbly
inerrantly	nrrntly
inerringly	nrrngly
inertly	nrtly
ineruditely	nrdtly
inescapably	nscpbly
inevitable	nvtbl
inexactly	nxctly
inexcusably	nxcsbly
inexorably	nxrbly
inexpertly	nxprtly
inexpiably	nxpbly
infamously	nfmsly
infancy	nfncy
infatuatedly	nfttdly
infectiously	nfctsly
inferiorly	nfrrly
infernally	nfrnlly
infertilely	nfrtlly
infidelly	nfdlly
infinitarily	nfntrly
infinitely	nfntly
infinitively	nfntvly
infirmly	nfrmly
inflamedly	nflmdly
inflammation	nflmmtn
inflatedly	nfltdly
inflation	nfltn
inflexibly	nflxbly
influence	nflnc
informally	nfrmlly
information	nfrmtn
informedly	nfrmdly
infuriately	nfrtly
infusedly	nfsdly
infusion	nfsn
ingenerably	ngnrbly
ingenerately	ngnrtly
ingenuously	ngnsly
inglenook	nglnk
ingloriously	nglrsly
ingrainedly	ngrndly
ingrate	ngrt
inherently	nhrntly
inheritably	nhrtbly
inhumanly	nhmnly
inimically	nmclly
iniquitously	nqtsly
initial	ntl
initiative	nttv
initiatorily	nttrly
injuredly	njrdly
injuriously	njrsly
injury	njry
injustice	njstc
ink	nk
innately	nntly
innaturally	nntrlly
innervation	nnrvtn
innocence	nncnc
innocent	nncnt
innocently	nncntly
innocuously	nncsly
innoxiously	nnxsly
innumerably	nnmrbly
inodorously	ndrsly
inofficiously	nffcsly
inopinately	npntly
input	npt
inquiringly	nqrngly
inquisitively	nqstvly
insanely	nsnly
insatiably	nstbly
insatiately	nsttly
inscription	nscrptn
insect	nsct
insensately	nsnstly
inseparably	nsprbly
inseparately	nsprtly
inseverably	nsvrbly
inside	nsd
insidiously	nsdsly
insinuatively	nsntvly
insipidly	nspdly
insipiently	nspntly
insolence	nslnc
insolubly	nslbly
insolvably	nslvbly
insouciantly	nscntly
inspection	nspctn
inspector	nspctr
inspiredly	nsprdly
instance	nstnc
instantly	nstntly
instruction	nstrctn
instrument	nstrmnt
insularly	nslrly
insulation	nsltn
insurance	nsrnc
insurgence	nsrgnc
intactly	ntctly
integrally	ntgrlly
integriously	ntgrsly
intelligence	ntllgnc
intemerately	ntmrtly
intendedly	ntnddly
intensely	ntnsly
intensively	ntnsvly
intention	ntntn
intentively	ntntvly
intently	ntntly
interaction	ntrctn
interactive	ntrctv
interest	ntrst
interfamily	ntrfmly
interior	ntrr
interiorly	ntrrly
interloper	ntrlpr
internal	ntrnl
internally	ntrnlly
international	ntrntnl
internet	ntrnt
interpreter	ntrprtr
intervenor	ntrvnr
interview	ntrvw
interviewer	ntrvwr
intestine	ntstn
intestines	ntstns
intimately	ntmtly
intrepidly	ntrpdly
intricately	ntrctly
introduction	ntrdctn
intrusively	ntrsvly
intuitionally	nttnlly
intuitively	nttvly
inurbanely	nrbnly
inutilely	ntlly
invariantly	nvrntly
invectively	nvctvly
invention	nvntn
inventively	nvntvly
inventor	nvntr
inventory	nvntry
inversedly	nvrsdly
inversely	nvrsly
invertedly	nvrtdly
investment	nvstmnt
inveterately	nvtrtly
invidiously	nvdsly
invincibly	nvncbly
invisibly	nvsbly
invite	nvt
invitingly	nvtngly
invoice	nvc
involutedly	nvltdly
involutely	nvltly
involvedly	nvlvdly
inwardly	nwrdly
irascibly	rscbly
irately	rtly
irefully	rflly
iridescence	rdscnc
irishly	rshly
irksomely	rksmly
ironclad	rncld
irony	rny
irrationably	rrtnbly
irrationally	rrtnlly
irrecusably	rrcsbly
irredeemably	rrdmbly
irreducibly	rrdcbly
irrefutably	rrftbly
irregularly	rrglrly
irrelatively	rrltvly
irreligiously	rrlgsly
irremeably	rrmbly
irremediably	rrmdbly
irremovably	rrmvbly
irreparably	rrprbly
irrepealably	rrplbly
irresolutely	rrsltly
irrevealably	rrvlbly
irrevocably	rrvcbly
irrigably	rrgbly
irritably	rrtbly
irritatedly	rrttdly
irruptively	rrptvly
isagogically	sggclly
island	slnd
isocephaly	scphly
isolatedly	sltdly
isomerically	smrclly
isophylly	sphylly
issuably	ssbly
issue	ss
italianately	tlntly
italianly	tlnly
iteratively	trtvly
itinerantly	tnrntly
jabbingly	jbbngly
jackal	jckl
jacket	jckt
jacobitely	jcbtly
jadedly	jddly
jadishly	jdshly
jaggedly	jggdly
jaguar	jgr
jail	jl
jailhouse	jlhs
jam	jm
james	jms
jangly	jngly
japanesquely	jpnsqly
japingly	jpngly
japishly	jpshly
japonically	jpnclly
jar	jr
jarfly	jrfly
jarringly	jrrngly
jasmine	jsmn
jauntingly	jntngly
jaw	jw
jazzily	jzzly
jealously	jlsly
jealousy	jlsy
jeans	jns
jeep	jp
jeeringly	jrngly
jeff	jff
jejunely	jjnly
jellily	jllly
jelly	jlly
jellyfish	jllyfsh
jemmily	jmmly
jeopardously	jprdsly
jerkily	jrkly
jerkingly	jrkngly
jestingly	jstngly
jesuitically	jstclly
jettingly	jttngly
jewel	jwl
jewelry	jwlry
jewely	jwly
jewishly	jwshly
jiffy	jffy
jiggly	jggly
jimply	jmply
job	jb
jockey	jcky
jocosely	jcsly
jocularly	jclrly
jocundly	jcndly
jodhpurs	jdhprs
jogging	jggng
join	jn
joiningly	jnngly
joint	jnt
jointedly	jntdly
jointly	jntly
joke	jk
jokingly	jkngly
joltingly	jltngly
jot	jt
journey	jrny
jovially	jvlly
jovianly	jvnly
joy	jy
joyfully	jyflly
joylessly	jylssly
joyously	jysly
jubilantly	jblntly
judaically	jdclly
judge	jdg
judgingly	jdgngly
judgment	jdgmnt
judicially	jdclly
judiciarily	jdcrly
judiciously	jdcsly
judo	jd
juggernaut	jggrnt
juice	jc
juicily	jcly
july	jly
jumbly	jmbly
jumbo	jmb
jump	jmp
jumper	jmpr
jumpingly	jmpngly
jumpsuit	jmpst
junior	jnr
junk	jnk
junker	jnkr
junket	jnkt
jurally	jrlly
juridically	jrdclly
jury	jry
justice	jstc
justifiably	jstfbly
justly	jstly
juvenilely	jvnlly
kamikaze	kmkz
kangaroo	kngr
karate	krt
karen	krn
kayak	kyk
kazoo	kz
keenly	knly
keep	kp
kelly	klly
kennelly	knnlly
kernelly	krnlly
ketch	ktch
ketchup	ktchp
kettle	kttl
kettledrum	kttldrm
key	ky
keyboard	kybrd
keyboarding	kybrdng
keystone	kystn
kick	kck
kick-off	kck-ff
kid	kd
kidney	kdny
kidneys	kdnys
kielbasa	klbs
kill	kll
killingly	kllngly
kilogram	klgrm
kilometer	klmtr
kilt	klt
kimberly	kmbrly
kimono	kmn
kind	knd
kindlily	kndlly
kindly	kndly
kindness	kndnss
kindredly	kndrdly
kinetically	kntclly
king	kng
kingfish	kngfsh
kinglily	knglly
kingly	kngly
kinkly	knkly
kinsmanly	knsmnly
kiosk	ksk
kiss	kss
kissingly	kssngly
kitchen	ktchn
kite	kt
kitten	kttn
kittens	kttns
kittly	kttly
kitty	ktty
kleenex	klnx
klomps	klmps
knavishly	knvshly
kneadingly	kndngly
knee	kn
kneejerk	knjrk
kneelingly	knlngly
knickers	knckrs
knife	knf
knife-edge	knf-dg
knight	knght
knightly	knghtly
knitting	knttng
knolly	knlly
knot	knt
knottily	knttly
knowingly	knwngly
knowledge	knwldg
knubbly	knbbly
knuckle	knckl
knuckly	knckly
knurly	knrly
koala	kl
kohlrabi	khlrb
koolooly	klly
labially	lblly
laboredly	lbrdly
laborer	lbrr
laboringly	lbrngly
laboriously	lbrsly
laborsomely	lbrsmly
labour	lbr
lace	lc
lacerately	lcrtly
lacily	lcly
laconically	lcnclly
lacquerware	lcqrwr
ladder	lddr
lady	ldy
ladybug	ldybg
ladyfly	ldyfly
ladylikely	ldylkly
ladyly	ldyly
laggardly	lggrdly
lake	lk
lamb	lmb
lambently	lmbntly
lambly	lmbly
lamellarly	lmllrly
lamellately	lmlltly
lamentably	lmntbly
lamentedly	lmntdly
lamp	lmp
lampfly	lmpfly
lancely	lncly
lanceolately	lncltly
land	lnd
landform	lndfrm
landmine	lndmn
landscape	lndscp
language	lngg
languidly	lngdly
languorously	lngrsly
lankily	lnkly
lantern	lntrn
laparoscope	lprscp
lapdog	lpdg
lapsingly	lpsngly
laptop	lptp
laputically	lptclly
larcenously	lrcnsly
larch	lrch
larder	lrdr
largely	lrgly
lark	lrk
laryngitis	lryngts
lasagna	lsgn
lasciviously	lscvsly
lashingly	lshngly
lastingly	lstngly
lately	ltly
latency	ltncy
latently	ltntly
latex	ltx
lathe	lth
latte	ltt
latterly	lttrly
laudably	ldbly
laudatorily	ldtrly
laugh	lgh
laughably	lghbly
laughingly	lghngly
laughter	lghtr
laundry	lndry
lawfully	lwflly
lawlessly	lwlssly
lawn	lwn
lawsuit	lwst
lawyer	lwyr
lawyerly	lwyrly
laxatively	lxtvly
laxly	lxly
lazarly	lzrly
lazily	lzly
leadenly	ldnly
leadership	ldrshp
leading	ldng
leadingly	ldngly
leaker	lkr
leapingly	lpngly
learnedly	lrndly
learning	lrnng
leash	lsh
leather	lthr
lecherously	lchrsly
lecture	lctr
leerily	lrly
leewardly	lwrdly
leg	lg
legal	lgl
legally	lglly
legging	lggng
legitimately	lgtmtly
legs	lgs
legume	lgm
leisurably	lsrbly
leisure	lsr
leisurely	lsrly
lemon	lmn
lemonade	lmnd
lemur	lmr
length	lngth
lengthily	lngthly
leniently	lnntly
lenitively	lntvly
lentil	lntl
leoninely	lnnly
leprosy	lprsy
leprously	lprsly
lesson	lssn
lethally	lthlly
letters	lttrs
leucocholy	lcchly
level	lvl
leverage	lvrg
levitically	lvtclly
lewdly	lwdly
libelously	lblsly
liberally	lbrlly
libidinally	lbdnlly
libidinously	lbdnsly
library	lbrry
license	lcns
licentiously	lcntsly
licitly	lctly
liegefully	lgflly
liegely	lgly
lier	lr
lifefully	lfflly
lifelessly	lflssly
lifesomely	lfsmly
lift	lft
light	lght
lighting	lghtng
lightly	lghtly
lightning	lghtnng
likely	lkly
lilac	llc
liltingly	lltngly
lily	lly
limit	lmt
limitatively	lmttvly
limitedly	lmtdly
limpidly	lmpdly
limpingly	lmpngly
limply	lmply
linearly	lnrly
linen	lnn
liner	lnr
lingually	lnglly
linguistics	lngstcs
link	lnk
linseed	lnsd
lion	ln
lip	lp
lipstick	lpstck
liquid	lqd
liquidly	lqdly
liquor	lqr
liquorishly	lqrshly
lisa	ls
lispingly	lspngly
lissomely	lssmly
list	lst
listen	lstn
literaily	ltrly
literally	ltrlly
literature	ltrtr
lithely	lthly
litigation	ltgtn
litigiously	ltgsly
litter	lttr
livelily	lvlly
lively	lvly
liver	lvr
livestock	lvstck
lividly	lvdly
living	lvng
lizard	lzrd
llama	llm
loaf	lf
loafer	lfr
loafingly	lfngly
loamily	lmly
loathfully	lthflly
loathingly	lthngly
loathsomely	lthsmly
lobately	lbtly
loblolly	lbllly
lobotomy	lbtmy
lobster	lbstr
lobularly	lblrly
local	lcl
locally	lclly
location	lctn
lock	lck
locker	lckr
locket	lckt
locomotive	lcmtv
locomotively	lcmtvly
locust	lcst
loftily	lftly
loggia	lgg
logic	lgc
logically	lgclly
logodaedaly	lgddly
loincloth	lnclth
loiteringly	ltrngly
lollingly	lllngly
lolly	llly
lonelily	lnlly
loneliness	lnlnss
lonely	lnly
lonesomely	lnsmly
longly	lngly
longsomely	lngsmly
loosely	lsly
lopsidedly	lpsddly
loquaciously	lqcsly
lordlily	lrdlly
loss	lss
lotion	ltn
loudly	ldly
lounge	lng
loungingly	lngngly
loutishly	ltshly
lovably	lvbly
lovelessly	lvlssly
loverly	lvrly
lovesomely	lvsmly
lovingly	lvngly
low	lw
loweringly	lwrngly
lowishly	lwshly
lowlily	lwlly
lowly	lwly
lownly	lwnly
loyally	lylly
loyalty	lylty
lubberly	lbbrly
lucently	lcntly
lucidly	lcdly
luciferously	lcfrsly
luckily	lckly
lucratively	lcrtvly
luculently	lclntly
ludicrously	ldcrsly
luetically	ltclly
luggage	lggg
lugubriously	lgbrsly
lukewarmly	lkwrmly
lumber	lmbr
lumberly	lmbrly
lumberman	lmbrmn
luminously	lmnsly
lumpishly	lmpshly
lunately	lntly
lunatically	lntclly
lunch	lnch
luncheonette	lnchntt
lunchroom	lnchrm
luridly	lrdly
luringly	lrngly
lurkingly	lrkngly
lusciously	lscsly
lushly	lshly
lustfully	lstflly
lustily	lstly
lustrously	lstrsly
luttuce	lttc
luxuriantly	lxrntly
luxuriously	lxrsly
lycra	lycr
lye	ly
lyingly	lyngly
lynx	lynx
lyocell	lycll
lyrately	lyrtly
lyre	lyr
lyric	lyrc
lyrically	lyrclly
macadamia	mcdm
macaroni	mcrn
machine	mchn
machinely	mchnly
machinery	mchnry
macrame	mcrm
macrocoly	mcrcly
macrofauna	mcrfn
maddingly	mddngly
maelstrom	mlstrm
magazine	mgzn
magic	mgc
magically	mgclly
maiden	mdn
mailbox	mlbx
mailman	mlmn
maimedly	mmdly
maintenance	mntnnc
major	mjr
major-league	mjr-lg
make	mk
makeup	mkp
maladroitly	mldrtly
malapertly	mlprtly
male	ml
malefically	mlfclly
maliciously	mlcsly
malignly	mlgnly
mall	mll
mallet	mllt
malodorously	mldrsly
mambo	mmb
mammoth	mmmth
manageably	mngbly
management	mngmnt
mandarin	mndrn
mandatorily	mndtrly
mandolin	mndln
manfully	mnflly
mangily	mngly
mangrove	mngrv
manhunt	mnhnt
maniac	mnc
maniacally	mnclly
manicure	mncr
manifestly	mnfstly
manifoldly	mnfldly
mankind	mnknd
manlessly	mnlssly
manlikely	mnlkly
manner	mnnr
mannerly	mnnrly
mannishly	mnnshly
mansard	mnsrd
manservant	mnsrvnt
mantle	mntl
manually	mnlly
manufacturer	mnfctrr
manurially	mnrlly
manx	mnx
many	mny
map	mp
maple	mpl
maraca	mrc
maracas	mrcs
marble	mrbl
marbly	mrbly
mare	mr
margin	mrgn
marginally	mrgnlly
margravely	mrgrvly
mariachi	mrch
marimba	mrmb
maritally	mrtlly
mark	mrk
markedly	mrkdly
market	mrkt
marketably	mrktbly
marketing	mrktng
marksman	mrksmn
marmoreally	mrmrlly
marriage	mrrg
marsh	mrsh
marshland	mrshlnd
martyrly	mrtyrly
marvelously	mrvlsly
marxism	mrxsm
mascara	mscr
masculinely	msclnly
masculy	mscly
mask	msk
massedly	mssdly
massively	mssvly
masterlily	mstrlly
masterly	mstrly
mastication	mstctn
mastoid	mstd
match	mtch
matchably	mtchbly
material	mtrl
materially	mtrlly
maternally	mtrnlly
math	mth
mathematics	mthmtcs
matronly	mtrnly
mattedly	mttdly
matter	mttr
mattock	mttck
mattress	mttrss
matutinally	mttnlly
matutinely	mttnly
maudlinly	mdlnly
mawkishly	mwkshly
maximally	mxmlly
maximum	mxmm
maybe	myb
mayonnaise	mynns
mayor	myr
mazedly	mzdly
mazily	mzly
meagerly	mgrly
mealily	mlly
meaning	mnng
meaningly	mnngly
meanly	mnly
measles	msls
measly	msly
measure	msr
measuredly	msrdly
measurement	msrmnt
meat	mt
meatily	mtly
mechanic	mchnc
medially	mdlly
medianly	mdnly
mediately	mdtly
mediatingly	mdtngly
mediatorially	mdtrlly
medically	mdclly
medicinally	mdcnlly
medicine	mdcn
medievally	mdvlly
meditatively	mdttvly
meekly	mkly
meeterly	mtrly
meeting	mtng
megacephaly	mgcphly
megaliac	mglc
meiophylly	mphylly
melancholy	mlnchly
mellowly	mllwly
melodially	mldlly
melodically	mldclly
melodiously	mldsly
melody	mldy
meltingly	mltngly
member	mmbr
membership	mmbrshp
membrally	mmbrlly
memorably	mmrbly
memorially	mmrlly
memory	mmry
menacingly	mncngly
mendaciously	mndcsly
menorah	mnrh
mensurably	mnsrbly
mentally	mntlly
mention	mntn
mercenarily	mrcnrly
mercifully	mrcflly
mercurially	mrcrlly
mercury	mrcry
merely	mrly
meridionally	mrdnlly
meritedly	mrtdly
meritoriously	mrtrsly
merrily	mrrly
mesally	mslly
mesocephaly	mscphly
message	mssg
messily	mssly
metaboly	mtbly
metal	mtl
metallicly	mtllcly
meteorically	mtrclly
meteorology	mtrlgy
methane	mthn
method	mthd
methodology	mthdlgy
meticulously	mtclsly
metronome	mtrnm
mezzanine	mzznn
mice	mc
microwave	mcrwv
mid-course	md-crs
middle	mddl
middleman	mddlmn
midline	mdln
midnight	mdnght
midweekly	mdwkly
midwife	mdwf
might	mght
mightily	mghtly
migrant	mgrnt
mildly	mldly
militantly	mltntly
militarily	mltrly
milk	mlk
milkily	mlkly
milkshake	mlkshk
millennium	mllnnm
millimeter	mllmtr
millisecond	mllscnd
mimetically	mmtclly
mimically	mmclly
mimly	mmly
mimosa	mms
minatorially	mntrlly
minatorily	mntrly
mindfully	mndflly
mingledly	mngldly
mini-skirt	mn-skrt
minibus	mnbs
minikinly	mnknly
minimally	mnmlly
minimum	mnmm
minion	mnn
minionly	mnnly
minor	mnr
minor-league	mnr-lg
minutely	mntly
minutiously	mntsly
minxishly	mnxshly
miraculously	mrclsly
mirror	mrrr
misapply	mspply
miscarriage	mscrrg
miserably	msrbly
miserly	msrly
misfit	msft
misguidedly	msgddly
misogyny	msgyny
misreading	msrdng
missile	mssl
missingly	mssngly
mission	mssn
mist	mst
mistakably	mstkbly
mistake	mstk
mistakenly	mstknly
mister	mstr
mitigatedly	mtgtdly
mitotically	mttclly
mitten	mttn
mix	mx
mixedly	mxdly
mixer	mxr
mixture	mxtr
mizzly	mzzly
mobbishly	mbbshly
mobile	mbl
moccasins	mccsns
mocha	mch
mockfully	mckflly
model	mdl
modem	mdm
moderately	mdrtly
modernly	mdrnly
modestly	mdstly
modifiably	mdfbly
moilingly	mlngly
molecularly	mlclrly
molehilly	mlhlly
molliently	mllntly
mollifiedly	mllfdly
molly	mlly
moltenly	mltnly
moly	mly
mom	mm
moment	mmnt
momentally	mmntlly
momentarily	mmntrly
momently	mmntly
momentously	mmntsly
monadically	mndclly
monastery	mnstry
monasticism	mnstcsm
monger	mngr
mongrelly	mngrlly
monitor	mntr
monkey	mnky
monkishly	mnkshly
monkly	mnkly
monocle	mncl
monocularly	mnclrly
monoeciously	mncsly
monogamously	mngmsly
monopodially	mnpdlly
monopoly	mnply
monostely	mnstly
monotheism	mnthsm
monsoon	mnsn
monster	mnstr
month	mnth
monthly	mnthly
mood	md
moodily	mdly
moodishly	mdshly
moon	mn
moonscape	mnscp
moonshine	mnshn
moorishly	mrshly
mopingly	mpngly
morally	mrlly
morbidly	mrbdly
mordaciously	mrdcsly
mordantly	mrdntly
moribundly	mrbndly
morigerously	mrgrsly
morning	mrnng
morsel	mrsl
mortgage	mrtgg
mortifiedly	mrtfdly
mortise	mrts
mosque	msq
mosquito	msqt
mother	mthr
motherly	mthrly
motor	mtr
motorboat	mtrbt
motorcar	mtrcr
motorcycle	mtrcycl
mound	mnd
mountably	mntbly
mountainously	mntnsly
mountingly	mntngly
mournfully	mrnflly
mourningly	mrnngly
mouse	ms
mousse	mss
moustache	mstch
mouthily	mthly
mouthingly	mthngly
mouthishly	mthshly
mouton	mtn
moveably	mvbly
movelessly	mvlssly
mover	mvr
movie	mv
movingly	mvngly
mower	mwr
muchly	mchly
mucronately	mcrntly
muddily	mddly
muggily	mggly
mukluk	mklk
mulishly	mlshly
multifidly	mltfdly
multimedia	mltmd
multiply	mltply
mumpishly	mmpshly
mundanely	mndnly
municipally	mncplly
murderously	mrdrsly
muriformly	mrfrmly
murkily	mrkly
murmurously	mrmrsly
muscle	mscl
muscularly	msclrly
musculature	mscltr
musefully	msflly
museum	msm
mushily	mshly
music	msc
music-box	msc-bx
musically	msclly
musicianly	mscnly
mussably	mssbly
mustard	mstrd
mustily	mstly
mutedly	mtdly
mutinously	mtnsly
mutt	mtt
mutually	mtlly
mycoplasma	mycplsm
myopically	mypclly
myriadly	myrdly
mysticly	mystcly
nabobishly	nbbshly
naifly	nfly
nail	nl
naively	nvly
nakedly	nkdly
name	nm
namelessly	nmlssly
naming	nmng
nanocephaly	nncphly
nanoparticle	nnprtcl
napkin	npkn
narratively	nrrtvly
narrowly	nrrwly
nastily	nstly
nasty	nsty
nation	ntn
national	ntnl
native	ntv
nattily	nttly
natural	ntrl
naturalisation	ntrlstn
naturally	ntrlly
nature	ntr
nauseatingly	nstngly
nauseously	nssly
nautically	ntclly
navally	nvlly
navigably	nvgbly
nebulously	nblsly
necessarily	ncssrly
necessary	ncssry
neck	nck
necklace	ncklc
necktie	nckt
necrophily	ncrphly
nectareously	nctrsly
needfully	ndflly
needily	ndly
needle	ndl
needlessly	ndlssly
nefariously	nfrsly
negative	ngtv
negatively	ngtvly
negligee	nglg
negligibly	nglgbly
negotiation	ngttn
neighborly	nghbrly
nelly	nlly
nemophily	nmphly
neologism	nlgsm
neon	nn
neoterically	ntrclly
nephew	nphw
nerve	nrv
nervily	nrvly
nervously	nrvsly
neshly	nshly
nest	nst
netball	ntbll
netsuke	ntsk
network	ntwrk
neurobiologist	nrblgst
neurotically	nrtclly
newly	nwly
news	nws
newspaper	nwsppr
newsprint	nwsprnt
newsstand	nwsstnd
nextly	nxtly
nexus	nxs
nicety	ncty
niche	nch
nickel	nckl
niece	nc
niggardly	nggrdly
niggly	nggly
nighly	nghly
night	nght
nightclub	nghtclb
nightgown	nghtgwn
nightingale	nghtngl
nightly	nghtly
nimbly	nmbly
ninthly	nnthly
nippily	npply
nippingly	nppngly
nitrogen	ntrgn
noblemanly	nblmnly
nobody	nbdy
nocuously	ncsly
noddingly	nddngly
noisefully	nsflly
noiselessly	nslssly
nomadically	nmdclly
nominately	nmntly
nominatively	nmntvly
nonapply	nnpply
nonbeliever	nnblvr
nonbodily	nnbdly
nonfamily	nnfmly
nonoily	nnly
nonsense	nnsns
nonsexually	nnsxlly
normal	nrml
normally	nrmlly
normanly	nrmnly
normatively	nrmtvly
north	nrth
northerly	nrthrly
nose	ns
notably	ntbly
note	nt
notebook	ntbk
notelessly	ntlssly
nothing	nthng
nothingly	nthngly
notice	ntc
noticeably	ntcbly
notify	ntfy
notionally	ntnlly
notoriety	ntrty
notoriously	ntrsly
nougat	ngt
noumenally	nmnlly
nounally	nnlly
novel	nvl
noxally	nxlly
noxiously	nxsly
nubbly	nbbly
nudge	ndg
number	nmbr
numbingly	nmbngly
numerably	nmrbly
numeracy	nmrcy
numeric	nmrc
numerically	nmrclly
numerously	nmrsly
numinously	nmnsly
numismatist	nmsmtst
nuptially	nptlly
nurse	nrs
nursery	nrsry
nursingly	nrsngly
nurture	nrtr
nutrition	ntrtn
nutritiously	ntrtsly
nutritively	ntrtvly
nylon	nyln
nymphly	nymphly
oak	k
oatmeal	tml
obdurately	bdrtly
obedience	bdnc
obedientially	bdntlly
obediently	bdntly
obesity	bsty
obeyingly	byngly
obituarily	btrly
object	bjct
objective	bjctv
objectively	bjctvly
obligation	blgtn
obligatorily	blgtrly
obligedly	blgdly
obligingly	blgngly
obliquely	blqly
obliviously	blvsly
oblongly	blngly
obnoxiously	bnxsly
oboe	b
obscenely	bscnly
obscuredly	bscrdly
obscurely	bscrly
obsequiously	bsqsly
observably	bsrvbly
observation	bsrvtn
observatory	bsrvtry
observedly	bsrvdly
obsoletely	bsltly
obstinately	bstntly
obtrusively	btrsvly
obtusely	btsly
obversely	bvrsly
obviously	bvsly
occasion	ccsn
occasionally	ccsnlly
occipitally	ccptlly
occultly	ccltly
occupation	ccptn
octagon	ctgn
octagonally	ctgnlly
octavo	ctv
octennially	ctnnlly
octet	ctt
octopus	ctps
octuply	ctply
ocularly	clrly
odically	dclly
odiously	dsly
odometer	dmtr
odoriferously	drfrsly
odorously	drsly
oeuvre	vr
off-ramp	ff-rmp
offence	ffnc
offendedly	ffnddly
offensively	ffnsvly
office	ffc
officer	ffcr
official	ffcl
officially	ffclly
officinally	ffcnlly
officiously	ffcsly
offishly	ffshly
ogreishly	grshly
okra	kr
oldie	ld
olfactorily	lfctrly
oligopoly	lgply
olive	lv
olympianly	lympnly
olympicly	lympcly
ombrophily	mbrphly
omelet	mlt
ominously	mnsly
omnifariously	mnfrsly
omnivorously	mnvrsly
oncology	nclgy
one	n
onerously	nrsly
oozily	zly
opaquely	pqly
opening	pnng
opera	pr
operabily	prbly
operatically	prtclly
operatively	prtvly
operosely	prsly
opinably	pnbly
opiniatively	pntvly
opinion	pnn
opinionatedly	pnntdly
opinionatively	pnntvly
opossum	pssm
opportunely	pprtnly
opportunist	pprtnst
opportunity	pprtnty
opposingly	ppsngly
opposite	ppst
optably	ptbly
option	ptn
optionally	ptnlly
oracularly	rclrly
orangutan	rngtn
orator	rtr
oratorically	rtrclly
orbicularly	rbclrly
orbiculately	rbcltly
orchard	rchrd
orchestra	rchstr
orchid	rchd
orchideously	rchdsly
order	rdr
orderly	rdrly
ordinally	rdnlly
ordinarily	rdnrly
ordinary	rdnry
ordination	rdntn
organisation	rgnstn
organization	rgnztn
orgulously	rglsly
orientally	rntlly
original	rgnl
originally	rgnlly
originarily	rgnrly
originatively	rgntvly
ornament	rnmnt
orphically	rphclly
orthodoxly	rthdxly
oscitantly	sctntly
osmosis	smss
osprey	spry
osseously	sssly
ostensibly	stnsbly
ostensively	stnsvly
ostrich	strch
other	thr
others	thrs
otocephaly	tcphly
otter	ttr
outback	tbck
outbully	tblly
outcome	tcm
outerly	trly
outfit	tft
outfly	tfly
outhouse	ths
outlay	tly
output	tpt
outrageously	trgsly
outrigger	trggr
outrightly	trghtly
outsally	tslly
outside	tsd
outspokenly	tspknly
ovary	vry
ovately	vtly
oven	vn
overanxiously	vrnxsly
overboldly	vrbldly
overbravely	vrbrvly
overcapably	vrcpbly
overcasually	vrcslly
overcautiously	vrctsly
overcharge	vrchrg
overcheaply	vrchply
overcleanly	vrclnly
overclosely	vrclsly
overcoat	vrct
overcoldly	vrcldly
overcoolly	vrclly
overcopiously	vrcpsly
overcostly	vrcstly
overcuriously	vrcrsly
overdaintily	vrdntly
overdearly	vrdrly
overdeeply	vrdply
overeagerly	vrgrly
overeasily	vrsly
overexertion	vrxrtn
overfacilely	vrfclly
overflight	vrflght
overfly	vrfly
overfondly	vrfndly
overfoully	vrflly
overfreely	vrfrly
overgently	vrgntly
overgladly	vrgldly
overgodly	vrgdly
overgreatly	vrgrtly
overgreedily	vrgrdly
overhastily	vrhstly
overheartily	vrhrtly
overheatedly	vrhtdly
overhighly	vrhghly
overholy	vrhly
overhomely	vrhmly
overhotly	vrhtly
overidly	vrdly
overjealously	vrjlsly
overkindly	vrkndly
overlargely	vrlrgly
overlaxly	vrlxly
overlewdly	vrlwdly
overlively	vrlvly
overloyally	vrlylly
overly	vrly
overmeekly	vrmkly
overmerrily	vrmrrly
overminutely	vrmntly
overnicely	vrncly
overnighter	vrnghtr
overply	vrply
overproudly	vrprdly
overquickly	vrqckly
overquietly	vrqtly
overrashly	vrrshly
overreadily	vrrdly
overrigidly	vrrgdly
overripely	vrrply
overroughly	vrrghly
oversadly	vrsdly
oversecurely	vrscrly
overseriously	vrsrsly
overseverely	vrsvrly
overshoot	vrsht
oversimply	vrsmply
overslowly	vrslwly
oversoftly	vrsftly
oversourly	vrsrly
overspeedily	vrspdly
overstately	vrsttly
oversubtly	vrsbtly
oversupply	vrspply
oversweetly	vrswtly
overtamely	vrtmly
overtediously	vrtdsly
overtensely	vrtnsly
overtly	vrtly
overusually	vrslly
overwilily	vrwlly
overwily	vrwly
overwisely	vrwsly
overwomanly	vrwmnly
overzealously	vrzlsly
owlishly	wlshly
owner	wnr
ox	x
oxen	xn
oxfly	xfly
oxford	xfrd
oxycephaly	xycphly
oxygen	xygn
oyster	ystr
pace	pc
pacemaker	pcmkr
pacifically	pcfclly
pack	pck
package	pckg
packet	pckt
pactionally	pctnlly
pad	pd
paddle	pddl
paddock	pddck
paganically	pgnclly
paganishly	pgnshly
paganly	pgnly
pagoda	pgd
pain	pn
painfully	pnflly
painlessly	pnlssly
paint	pnt
paintably	pntbly
painter	pntr
painterly	pntrly
painting	pntng
paintwork	pntwrk
pajama	pjm
pajamas	pjms
palaeostyly	plstyly
palatably	pltbly
palatially	pltlly
palebelly	plblly
palely	plly
palliatively	plltvly
pallidly	plldly
palm	plm
palmately	plmtly
palpably	plpbly
palterly	pltrly
paly	ply
pamperedly	pmprdly
pamphlet	pmphlt
pancake	pnck
pancreas	pncrs
panderly	pndrly
pangamously	pngmsly
panic	pnc
panically	pnclly
paniculately	pncltly
pannier	pnnr
pannosely	pnnsly
panoply	pnply
panpipe	pnpp
pansy	pnsy
panther	pnthr
panties	pnts
pantingly	pntngly
pantologist	pntlgst
pantology	pntlgy
pantry	pntry
pantsuit	pntst
panty	pnty
pantyhose	pntyhs
papally	pplly
paperback	pprbck
papistly	ppstly
parable	prbl
parachute	prcht
parallelly	prlllly
paramedic	prmdc
paramountly	prmntly
parcel	prcl
parchedly	prchdly
parchment	prchmnt
pardonably	prdnbly
parentally	prntlly
parentheses	prnthss
parisianly	prsnly
parka	prk
parking	prkng
parlously	prlsly
parochially	prchlly
parrot	prrt
parsnip	prsnp
parsonly	prsnly
part	prt
partially	prtlly
participant	prtcpnt
particular	prtclr
partitively	prttvly
partner	prtnr
partridge	prtrdg
party	prty
pasilaly	pslly
pass	pss
passage	pssg
passbook	pssbk
passenger	pssngr
passingly	pssngly
passion	pssn
passionately	pssntly
passive	pssv
passively	pssvly
past	pst
pastor	pstr
pastoralist	pstrlst
pastorally	pstrlly
pastorly	pstrly
pastry	pstry
patchily	ptchly
patentably	ptntbly
patently	ptntly
paternally	ptrnlly
path	pth
patheticly	pthtcly
patience	ptnc
patient	ptnt
patriarch	ptrrch
patricia	ptrc
patricianly	ptrcnly
patrimony	ptrmny
patriot	ptrt
patriotly	ptrtly
patrol	ptrl
patronly	ptrnly
pattern	pttrn
patulously	ptlsly
paunchily	pnchly
paurometaboly	prmtbly
pausably	psbly
pause	ps
pausefully	psflly
pauselessly	pslssly
pavement	pvmnt
pavilion	pvln
paw	pw
pawkily	pwkly
pawnshop	pwnshp
pay	py
payably	pybly
payment	pymnt
pea	p
peaceably	pcbly
peacefully	pcflly
peach	pch
peacoat	pct
peacock	pcck
peacockly	pcckly
peakedly	pkdly
peakishly	pkshly
pearl	prl
peasantly	psntly
pebbly	pbbly
peccantly	pccntly
peckishly	pckshly
peckly	pckly
pectinately	pctntly
pectorally	pctrlly
peculiarly	pclrly
pecuniarily	pcnrly
pedal	pdl
pedanticly	pdntcly
pedately	pdtly
peer-to-peer	pr-t-pr
peeringly	prngly
peerlessly	prlssly
peerly	prly
peevedly	pvdly
peevishly	pvshly
pegboard	pgbrd
pejoratively	pjrtvly
pelican	plcn
pellucidly	pllcdly
peltately	plttly
peltingly	pltngly
penally	pnlly
penalty	pnlty
pencil	pncl
pendant	pndnt
pendently	pndntly
pendulously	pndlsly
pendulum	pndlm
penetrably	pntrbly
penicillin	pnclln
penitently	pntntly
pension	pnsn
pensionably	pnsnbly
pensively	pnsvly
pentagon	pntgn
penuriously	pnrsly
pepper	pppr
pepperily	ppprly
perceivably	prcvbly
perceivedly	prcvdly
percentage	prcntg
perception	prcptn
perch	prch
perdurably	prdrbly
perennially	prnnlly
perfectly	prfctly
perfidiously	prfdsly
performance	prfrmnc
perfume	prfm
periodical	prdcl
peripheral	prphrl
perishably	prshbly
peritoneally	prtnlly
perjinkly	prjnkly
perjuredly	prjrdly
perjuriously	prjrsly
perkily	prkly
perkingly	prkngly
permafrost	prmfrst
permeably	prmbly
permission	prmssn
permit	prmt
perniciously	prncsly
perp	prp
perpetually	prptlly
perradially	prrdlly
person	prsn
personably	prsnbly
personal	prsnl
personality	prsnlty
personally	prsnlly
personately	prsntly
perspective	prspctv
persuadably	prsdbly
persuadedly	prsddly
persuasibly	prssbly
persuasively	prssvly
pervasively	prvsvly
perversely	prvrsly
peskily	pskly
petal	ptl
petitionarily	pttnrly
pets	pts
pettedly	pttdly
petticoat	pttct
pettily	pttly
pettingly	pttngly
petulantly	ptlntly
pha	ph
pharmacist	phrmcst
pharmacopoeia	phrmcp
phase	phs
pheasant	phsnt
philately	phltly
philocaly	phlcly
philosopher	phlsphr
philosophy	phlsphy
phone	phn
photo	pht
photophily	phtphly
phrasally	phrslly
phrase	phrs
physical	physcl
physics	physcs
pianist	pnst
piccadilly	pccdlly
piccolo	pccl
pickax	pckx
pickedly	pckdly
pickle	pckl
picturably	pctrbly
picture	pctr
picturely	pctrly
piebaldly	pbldly
piedly	pdly
piercingly	prcngly
piety	pty
pig	pg
pigbelly	pgblly
pigeon	pgn
piggishly	pggshly
pigheadedly	pghddly
pigly	pgly
pigs	pgs
pike	pk
pilgrimage	plgrmg
pillbox	pllbx
pillow	pllw
pimp	pmp
pimple	pmpl
pimply	pmply
pinafore	pnfr
pince-nez	pnc-nz
pinchedly	pnchdly
pineapple	pnppl
pinecone	pncn
ping	png
piningly	pnngly
pinkie	pnk
pinkily	pnkly
pinnately	pnntly
pinningly	pnnngly
pinstripe	pnstrp
pinworm	pnwrm
pioneer	pnr
piously	psly
pipe	pp
piperly	pprly
pipingly	ppngly
piquantly	pqntly
piracy	prcy
pitch	ptch
pitching	ptchng
piteously	ptsly
pithily	pthly
pitifully	ptflly
pitilessly	ptlssly
pityingly	ptyngly
pivotally	pvtlly
pizza	pzz
pizzas	pzzs
placably	plcbly
placatively	plctvly
placidly	plcdly
plaguily	plgly
plain	pln
plainly	plnly
plaintively	plntvly
planes	plns
planfully	plnflly
plant	plnt
plantation	plnttn
planter	plntr
planterly	plntrly
plants	plnts
plaster	plstr
plastic	plstc
plasticly	plstcly
platform	pltfrm
platinum	pltnm
platypus	pltyps
plausibly	plsbly
player	plyr
playfully	plyflly
playground	plygrnd
playroom	plyrm
playsomely	plysmly
pleadingly	pldngly
pleasantly	plsntly
pleasedly	plsdly
pleasingly	plsngly
pleasurably	plsrbly
pleasure	plsr
pleated	pltd
plebeianly	plbnly
plenarily	plnrly
plenteously	plntsly
plenty	plnty
pliably	plbly
pliantly	plntly
plicately	plctly
plodderly	plddrly
plot	plt
plough	plgh
plover	plvr
plow	plw
plowman	plwmn
pluckily	plckly
plumosely	plmsly
plumply	plmply
plunger	plngr
plurally	plrlly
plushily	plshly
plyingly	plyngly
plywood	plywd
pneumonia	pnmn
pocketbook	pcktbk
poem	pm
poet	pt
poetically	ptclly
poetry	ptry
poignance	pgnnc
poignantly	pgnntly
pointedly	pntdly
pointfully	pntflly
poison	psn
poisonfully	psnflly
poisoning	psnng
poisonously	psnsly
pokerishly	pkrshly
pokily	pkly
polarly	plrly
polemically	plmclly
police	plc
policeman	plcmn
policy	plcy
polish	plsh
polishedly	plshdly
politely	pltly
politically	pltclly
politicly	pltcly
politics	pltcs
pollutedly	plltdly
pollution	plltn
polly	plly
polyester	plystr
polymely	plymly
polyoeciously	plycsly
polythely	plythly
pompom	pmpm
pompously	pmpsly
pond	pnd
ponderously	pndrsly
pony	pny
poof	pf
pool	pl
popcorn	ppcrn
popeholy	pphly
popely	pply
poplolly	ppllly
popply	ppply
popsicle	ppscl
popularly	pplrly
population	ppltn
populist	pplst
populously	pplsly
porcupine	prcpn
portably	prtbly
porter	prtr
porterly	prtrly
portfolio	prtfl
porthole	prthl
posingly	psngly
position	pstn
positive	pstv
positively	pstvly
possession	pssssn
possibility	pssblty
possible	pssbl
possibly	pssbly
postage	pstg
postally	pstlly
postaxially	pstxlly
postbox	pstbx
posteriorly	pstrrly
postically	pstclly
postingly	pstngly
potato	ptt
potbelly	ptblly
potential	ptntl
potentially	ptntlly
potty	ptty
poultry	pltry
pouncingly	pncngly
pounding	pndng
poutingly	ptngly
poverty	pvrty
powder	pwdr
power	pwr
powerfully	pwrflly
practice	prctc
praisably	prsbly
praisefully	prsflly
praisingly	prsngly
prandially	prndlly
pratingly	prtngly
preachily	prchly
preacidly	prcdly
preacutely	prctly
preadequately	prdqtly
preallably	prllbly
preaxially	prxlly
precariously	prcrsly
precatively	prctvly
precautiously	prctsly
precedent	prcdnt
precipitation	prcpttn
precisely	prcsly
predatorily	prdtrly
predeathly	prdthly
predicably	prdcbly
preface	prfc
prefatorily	prftrly
preferably	prfrbly
preference	prfrnc
prefixally	prfxlly
prefixedly	prfxdly
prelude	prld
preludiously	prldsly
prelusively	prlsvly
prelusorily	prlsrly
prematurely	prmtrly
premeditation	prmdttn
premier	prmr
premorally	prmrlly
preobviously	prbvsly
preoccupation	prccptn
preorally	prrlly
preparation	prprtn
preparedly	prprdly
preroyally	prrylly
presence	prsnc
present	prsnt
presentation	prsnttn
president	prsdnt
press	prss
pressroom	prssrm
pressure	prssr
presuitably	prstbly
presumably	prsmbly
presumedly	prsmdly
presupply	prspply
pretardily	prtrdly
pretimely	prtmly
prettily	prttly
prevalidly	prvldly
previously	prvsly
previsibly	prvsbly
prevocally	prvclly
price	prc
priceably	prcbly
prickly	prckly
pride	prd
pridefully	prdflly
pridingly	prdngly
priest	prst
priesthood	prsthd
priestly	prstly
primarily	prmrly
primary	prmry
primely	prmly
primevally	prmvlly
primitively	prmtvly
prince	prnc
princely	prncly
princess	prncss
principal	prncpl
print	prnt
printer	prntr
prior	prr
priority	prrty
priorly	prrly
prissily	prssly
private	prvt
privately	prvtly
privatively	prvtvly
privily	prvly
prize	prz
prizefight	przfght
probably	prbbly
probation	prbtn
probatively	prbtvly
problem	prblm
procaciously	prccsly
procedure	prcdr
process	prcss
processing	prcssng
prodigally	prdglly
prodigiously	prdgsly
produce	prdc
producer	prdcr
product	prdct
production	prdctn
profanably	prfnbly
profanely	prfnly
profession	prfssn
professional	prfssnl
professor	prfssr
proficuously	prfcsly
profile	prfl
profit	prft
profitably	prftbly
profoundly	prfndly
profusely	prfsly
profusively	prfsvly
program	prgrm
progress	prgrss
project	prjct
prolately	prltly
prolatively	prltvly
prolificly	prlfcly
prolixly	prlxly
promise	prms
promonopoly	prmnply
promotion	prmtn
prompt	prmpt
promptly	prmptly
pronely	prnly
pronunciation	prnnctn
proof	prf
proof-reader	prf-rdr
propane	prpn
propensely	prpnsly
properly	prprly
property	prprty
propitiously	prptsly
proposal	prpsl
prosaically	prsclly
prose	prs
prosecution	prsctn
prosodially	prsdlly
proteanly	prtnly
protection	prtctn
protest	prtst
protocol	prtcl
proudishly	prdshly
provably	prvbly
provedly	prvdly
provenly	prvnly
provingly	prvngly
provisorily	prvsrly
prow	prw
proxically	prxclly
proximally	prxmlly
proximately	prxmtly
prudely	prdly
prudently	prdntly
prunably	prnbly
pruner	prnr
pruriently	prrntly
pryingly	pryngly
pseudoscience	psdscnc
ptarmigan	ptrmgn
public	pblc
publicity	pblcty
publicly	pblcly
publisher	pblshr
pudding	pddng
puddly	pddly
pudgily	pdgly
puerilely	prlly
puffily	pffly
puffin	pffn
puffingly	pffngly
pugnaciously	pgncsly
pulingly	plngly
pull	pll
pulpily	plply
pulpitly	plptly
pulsatively	plstvly
pulvinately	plvntly
pumpkin	pmpkn
pumpkinseed	pmpknsd
punch	pnch
punctually	pnctlly
punctuation	pncttn
pungently	pngntly
punily	pnly
punishably	pnshbly
punishment	pnshmnt
punitionally	pntnlly
pupil	ppl
puppetly	ppptly
puppy	pppy
purchase	prchs
purfly	prfly
purgatively	prgtvly
puritan	prtn
puritanly	prtnly
purple	prpl
purplely	prplly
purply	prply
purpose	prps
purposedly	prpsdly
purposely	prpsly
purposively	prpsvly
purringly	prrngly
purulently	prlntly
push	psh
pusher	pshr
pushfully	pshflly
pushingly	pshngly
putatively	pttvly
putidly	ptdly
putridly	ptrdly
puzzledly	pzzldly
pvc	pvc
pyjama	pyjm
pyramid	pyrmd
quackishly	qckshly
quadrant	qdrnt
quadrantly	qdrntly
quadruply	qdrply
quaffingly	qffngly
quail	ql
quaily	qly
quaintly	qntly
quakerishly	qkrshly
quakerly	qkrly
quakingly	qkngly
qualifiedly	qlfdly
qualitatively	qlttvly
quality	qlty
qualmishly	qlmshly
quantifiably	qntfbly
quantitively	qnttvly
quantity	qntty
quart	qrt
quarter	qrtr
quarterly	qrtrly
quartz	qrtz
queasily	qsly
queen	qn
queerly	qrly
quemefully	qmflly
quemely	qmly
querimoniously	qrmnsly
querulously	qrlsly
queryingly	qryngly
questingly	qstngly
question	qstn
questionably	qstnbly
quickly	qckly
quicksand	qcksnd
quiescently	qscntly
quietly	qtly
quill	qll
quilt	qlt
quince	qnc
quit	qt
quiver	qvr
quiveringly	qvrngly
quixotically	qxtclly
quizzically	qzzclly
quizzingly	qzzngly
quondamly	qndmly
quotably	qtbly
quotation	qttn
quotationally	qttnlly
quotidianly	qtdnly
quotingly	qtngly
rabbi	rbb
rabbit	rbbt
rabbits	rbbts
rabidly	rbdly
raccoon	rccn
race	rc
racemosely	rcmsly
racer	rcr
racially	rclly
racily	rcly
racing	rcng
racism	rcsm
racist	rcst
rack	rck
rackingly	rckngly
radially	rdlly
radiately	rdtly
radiator	rdtr
radically	rdclly
radioactively	rdctvly
radiosonde	rdsnd
radish	rdsh
raffishly	rffshly
raffle	rffl
raft	rft
rage	rg
ragefully	rgflly
rageously	rgsly
raggedly	rggdly
raggily	rggly
raguly	rgly
rail	rl
railingly	rlngly
railway	rlwy
raiment	rmnt
rainbow	rnbw
raincoat	rnct
rainily	rnly
rainmaker	rnmkr
rainstorm	rnstrm
rake	rk
rakehelly	rkhlly
rakily	rkly
rakishly	rkshly
rally	rlly
rambler	rmblr
rammishly	rmmshly
ramosely	rmsly
rampaciously	rmpcsly
rampageously	rmpgsly
rampantly	rmpntly
ranch	rnch
rancidly	rncdly
rancorously	rncrsly
random	rndm
randomisation	rndmstn
randomly	rndmly
rank	rnk
rantingly	rntngly
rapaciously	rpcsly
rapidly	rpdly
raptly	rptly
rapturously	rptrsly
rarely	rrly
rascally	rsclly
raspberry	rspbrry
raspingly	rspngly
ratably	rtbly
ratchelly	rtchlly
rathely	rthly
ratherly	rthrly
rationably	rtnbly
rationally	rtnlly
rattly	rttly
raucously	rcsly
raven	rvn
ravenously	rvnsly
ravingly	rvngly
ravioli	rvl
ravishedly	rvshdly
rawhide	rwhd
ray	ry
rayon	ryn
razzly	rzzly
reactant	rctnt
reaction	rctn
reactionally	rctnlly
reactively	rctvly
reading	rdng
reality	rlty
realizably	rlzbly
realizingly	rlzngly
reapply	rpply
rear	rr
rearwardly	rrwrdly
reason	rsn
reasonably	rsnbly
reasonedly	rsndly
reasoningly	rsnngly
reassembly	rssmbly
reassuredly	rssrdly
rebelliously	rbllsly
rebelly	rblly
rebuffably	rbffbly
rebukefully	rbkflly
rebukingly	rbkngly
receipt	rcpt
recently	rcntly
reception	rcptn
receptively	rcptvly
receptually	rcptlly
recess	rcss
recessively	rcssvly
recipe	rcp
recitatively	rcttvly
reclaimably	rclmbly
recliner	rclnr
reclusely	rclsly
recognition	rcgntn
recoilingly	rclngly
recomply	rcmply
reconditely	rcndtly
record	rcrd
recordedly	rcrddly
recorder	rcrdr
recording	rcrdng
recover	rcvr
recreantly	rcrntly
recreation	rcrtn
recreatively	rcrtvly
recruit	rcrt
rectally	rctlly
rectangle	rctngl
redbelly	rdblly
redeemably	rdmbly
redesign	rdsgn
redheadedly	rdhddly
rediscovery	rdscvry
redolently	rdlntly
redoubtably	rdbtbly
reducibly	rdcbly
reduction	rdctn
reedily	rdly
reef	rf
reekingly	rkngly
refectory	rfctry
reference	rfrnc
referently	rfrntly
refinedly	rfndly
refiningly	rfnngly
reflection	rflctn
reflexively	rflxvly
reflexly	rflxly
reformedly	rfrmdly
refrigerator	rfrgrtr
refund	rfnd
refuse	rfs
refusingly	rfsngly
refutably	rftbly
regally	rglly
region	rgn
register	rgstr
regret	rgrt
regular	rglr
regularly	rglrly
regulation	rgltn
regulatively	rgltvly
reindeer	rndr
reiteratedly	rtrtdly
reiteratively	rtrtvly
reject	rjct
rejoicingly	rjcngly
relation	rltn
relationally	rltnlly
relationship	rltnshp
relative	rltv
relatively	rltvly
relaxation	rlxtn
relaxedly	rlxdly
release	rls
relevantly	rlvntly
reliability	rlblty
reliably	rlbly
reliantly	rlntly
relief	rlf
relievedly	rlvdly
relievingly	rlvngly
religion	rlgn
religiously	rlgsly
relish	rlsh
remarkably	rmrkbly
remarkedly	rmrkdly
remediably	rmdbly
remedially	rmdlly
reminder	rmndr
remissively	rmssvly
remissly	rmssly
remote	rmt
remotely	rmtly
removably	rmvbly
remove	rmv
removedly	rmvdly
remultiply	rmltply
remunerably	rmnrbly
renably	rnbly
renewably	rnwbly
renewedly	rnwdly
renishly	rnshly
renownedly	rnwndly
rent	rnt
repair	rpr
repandly	rpndly
reparably	rprbly
reparation	rprtn
repeat	rpt
repeatedly	rptdly
repertorily	rprtrly
repetitiously	rpttsly
repetitively	rpttvly
repiningly	rpnngly
replace	rplc
replacement	rplcmnt
repletely	rpltly
repletively	rpltvly
replication	rplctn
reply	rply
reportedly	rprtdly
reposedly	rpsdly
reposefully	rpsflly
reprovably	rprvbly
republic	rpblc
repulsively	rplsvly
reputably	rptbly
reputation	rpttn
request	rqst
requirement	rqrmnt
requisitely	rqstly
resale	rsl
research	rsrch
reserve	rsrv
reservedly	rsrvdly
resident	rsdnt
resignedly	rsgndly
resinously	rsnsly
resist	rsst
resistibly	rsstbly
resistively	rsstvly
resolutely	rsltly
resolution	rsltn
resolve	rslv
resolvedly	rslvdly
resonantly	rsnntly
resort	rsrt
resource	rsrc
respect	rspct
respite	rspt
respond	rspnd
response	rspns
rest	rst
restaurant	rstrnt
restfully	rstflly
restively	rstvly
result	rslt
resupply	rspply
retailer	rtlr
retentively	rtntvly
rethinking	rthnkng
reticently	rtcntly
reticularly	rtclrly
retiredly	rtrdly
retiringly	rtrngly
retouch	rtch
retrievably	rtrvbly
retrorsely	rtrrsly
return	rtrn
reunitedly	rntdly
revealedly	rvldly
revealingly	rvlngly
revelly	rvlly
revenant	rvnnt
revenge	rvng
reverendly	rvrndly
reverently	rvrntly
reversedly	rvrsdly
reversely	rvrsly
reversibly	rvrsbly
revertively	rvrtvly
review	rvw
revivably	rvvbly
revivingly	rvvngly
revocably	rvcbly
revokingly	rvkngly
revolubly	rvlbly
revolution	rvltn
revolvably	rvlvbly
revolve	rvlv
revolver	rvlvr
revulsively	rvlsvly
reward	rwrd
rewardably	rwrdbly
rewardedly	rwrddly
rheumatism	rhmtsm
rheumily	rhmly
rhinoceros	rhncrs
rhomboidly	rhmbdly
rhyme	rhym
rhythm	rhythm
riantly	rntly
ribaldly	rbldly
rich	rch
richly	rchly
ricketily	rcktly
ridably	rdbly
riddle	rddl
ridge	rdg
ridgingly	rdgngly
ridiculously	rdclsly
rifely	rfly
rifle	rfl
right	rght
righteously	rghtsly
rightly	rghtly
rigidly	rgdly
rigorously	rgrsly
ring	rng
ringingly	rngngly
rings	rngs
ringworm	rngwrm
riotingly	rtngly
riotously	rtsly
rip	rp
rippingly	rppngly
ripple	rppl
riser	rsr
risibly	rsbly
risk	rsk
riskily	rskly
ritually	rtlly
river	rvr
riverbed	rvrbd
riverly	rvrly
rivulet	rvlt
roadway	rdwy
roamingly	rmngly
roaringly	rrngly
roastingly	rstngly
robe	rb
robin	rbn
robustiously	rbstsly
robustly	rbstly
rockably	rckbly
rocker	rckr
rocket	rckt
rod	rd
rodentially	rdntlly
roguishly	rgshly
roisterly	rstrly
roisterously	rstrsly
roll	rll
roller	rllr
rollingly	rllngly
romanly	rmnly
romanticly	rmntcly
romishly	rmshly
rompingly	rmpngly
rompishly	rmpshly
room	rm
roomily	rmly
roomthily	rmthly
rooster	rstr
rootedly	rtdly
rose	rs
rostrally	rstrlly
rostrum	rstrm
rotate	rtt
rotatively	rttvly
rottenly	rttnly
rotundly	rtndly
rough	rgh
roughishly	rghshly
roughly	rghly
round	rnd
roundabout	rndbt
roundaboutly	rndbtly
roundedly	rnddly
roundly	rndly
rousingly	rsngly
route	rt
routine	rtn
routinely	rtnly
row	rw
rowboat	rwbt
rowdily	rwdly
royal	ryl
royally	rylly
royetously	rytsly
rubber	rbbr
rubbish	rbbsh
rubbishly	rbbshly
rubbly	rbbly
rubric	rbrc
rubrically	rbrclly
ruckus	rcks
ruddily	rddly
ruffianly	rffnly
ruffly	rffly
rugby	rgby
ruinously	rnsly
rumbly	rmbly
ruminantly	rmnntly
ruminatively	rmntvly
rummily	rmmly
rumply	rmply
runaway	rnwy
runically	rnclly
runkly	rnkly
runner	rnnr
runningly	rnnngly
runtishly	rntshly
rush	rsh
rushingly	rshngly
rusticly	rstcly
rustily	rstly
rutabaga	rtbg
ruthfully	rthflly
ruttishly	rttshly
sabbathly	sbbthly
sably	sbly
sabre	sbr
sacredly	scrdly
sad	sd
saddle	sddl
safe	sf
safely	sfly
safety	sfty
sagaciously	sgcsly
sagely	sgly
sagittally	sgttlly
sailboat	slbt
sailor	slr
sailorly	slrly
saintlily	sntlly
salaciously	slcsly
salary	slry
salesman	slsmn
sally	slly
salmon	slmn
saloon	sln
saltishly	sltshly
saltly	sltly
salubriously	slbrsly
salutatorily	slttrly
salvably	slvbly
samely	smly
samovar	smvr
sampan	smpn
sample	smpl
samurai	smr
sand	snd
sandals	sndls
sandbar	sndbr
sandwich	sndwch
sanguinarily	sngnrly
sanguinely	sngnly
sanitarily	sntrly
sapientially	spntlly
sapiently	spntly
sardine	srdn
sarong	srng
sartorially	srtrlly
sash	ssh
satanically	stnclly
satellite	stllt
satire	str
satirically	strclly
satisfaction	stsfctn
satisfiedly	stsfdly
saturninely	strnnly
sauce	sc
saucily	scly
sausage	ssg
savagely	svgly
save	sv
saving	svng
savingly	svngly
savings	svngs
saviour	svr
saw	sw
sawbelly	swblly
sawfly	swfly
saxonically	sxnclly
saxonly	sxnly
saxophone	sxphn
scabbily	scbbly
scabrously	scbrsly
scalably	sclbly
scale	scl
scallion	sclln
scanner	scnnr
scantily	scntly
scarcely	scrcly
scarecrow	scrcrw
scarf	scrf
scarification	scrfctn
scasely	scsly
scene	scn
scenery	scnry
scenically	scnclly
scent	scnt
schedule	schdl
schelly	schlly
scheme	schm
schnitzel	schntzl
scholarly	schlrly
school	schl
schoolhouse	schlhs
schooner	schnr
schorly	schrly
sciatically	sctclly
science	scnc
scimitar	scmtr
scissors	scssrs
sclerocauly	sclrcly
scooter	sctr
score	scr
scorn	scrn
scoutingly	sctngly
scow	scw
scraggily	scrggly
scrambly	scrmbly
scraper	scrpr
scrappily	scrpply
scratch	scrtch
scrawly	scrwly
scrawnily	scrwnly
screamer	scrmr
screechily	scrchly
screw	scrw
screw-up	scrw-p
scrim	scrm
scrimpily	scrmply
scrip	scrp
script	scrpt
scrivenly	scrvnly
scrolly	scrlly
scrubbily	scrbbly
scuffly	scffly
sculpting	sclptng
sculpture	sclptr
scurfily	scrfly
scurvily	scrvly
seafood	sfd
seagull	sgll
seamanly	smnly
seamlessly	smlssly
seaplane	spln
search	srch
seashore	sshr
seaside	ssd
season	ssn
seasonably	ssnbly
seasonally	ssnlly
seasonedly	ssndly
seawardly	swrdly
secludedly	sclddly
seclusively	sclsvly
second	scnd
secondarily	scndrly
secondly	scndly
secret	scrt
secretariat	scrtrt
secretary	scrtry
secretively	scrtvly
secretly	scrtly
sectarianly	sctrnly
section	sctn
sectional	sctnl
sectionally	sctnlly
secularly	sclrly
securely	scrly
security	scrty
sedately	sdtly
sedentarily	sdntrly
seditiously	sdtsly
seducingly	sdcngly
seductively	sdctvly
sedulously	sdlsly
seeder	sdr
seeingly	sngly
seemably	smbly
seemingly	smngly
seethingly	sthngly
segment	sgmnt
seismically	ssmclly
sejunctly	sjnctly
seldomly	sldmly
select	slct
selectedly	slctdly
selection	slctn
selectively	slctvly
selectly	slctly
self	slf
selfishly	slfshly
selfly	slfly
sellably	sllbly
selly	slly
semblably	smblbly
semiannually	smnnlly
semicircle	smcrcl
semicolon	smcln
semidaily	smdly
semimonopoly	smmnply
seminally	smnlly
semiseriously	smsrsly
semiseverely	smsvrly
semitonally	smtnlly
semiweekly	smwkly
semiyearly	smyrly
senator	sntr
senatorially	sntrlly
senilely	snlly
senior	snr
sense	sns
sensibly	snsbly
sensitive	snstv
sensitively	snstvly
sensually	snslly
sensuously	snssly
sentence	sntnc
sentiently	sntntly
sepal	spl
separatedly	sprtdly
separately	sprtly
septicaemia	sptcm
sequaciously	sqcsly
sequentially	sqntlly
serenely	srnly
serfishly	srfshly
series	srs
seriously	srsly
serpently	srpntly
serriedly	srrdly
servant	srvnt
serve	srv
server	srvr
service	srvc
serviceably	srvcbly
servilely	srvlly
session	sssn
setting	sttng
settledly	sttldly
settler	sttlr
seventhly	svnthly
severally	svrlly
severedly	svrdly
severely	svrly
severingly	svrngly
sewer	swr
sex	sx
sexennially	sxnnlly
sexlessly	sxlssly
sexly	sxly
sextiply	sxtply
shabbily	shbbly
shachly	shchly
shack	shck
shackly	shckly
shadbelly	shdblly
shade	shd
shadily	shdly
shadow	shdw
shadowbox	shdwbx
shadowily	shdwly
shaggily	shggly
shake	shk
shakebly	shkbly
shakedown	shkdwn
shakenly	shknly
shaker	shkr
shakily	shkly
shakingly	shkngly
shallot	shllt
shallowly	shllwly
shamably	shmbly
shame	shm
shamefully	shmflly
shampoo	shmp
shanty	shnty
shapely	shply
shapingly	shpngly
shark	shrk
sharply	shrply
shawl	shwl
shearling	shrlng
shears	shrs
sheath	shth
sheenly	shnly
sheep	shp
sheepishly	shpshly
sheerly	shrly
sheet	sht
sheikhly	shkhly
shelf	shlf
shell	shll
shelly	shlly
shelter	shltr
sherry	shrry
shield	shld
shift	shft
shiftily	shftly
shin	shn
shingle	shngl
shingly	shngly
shiningly	shnngly
shirt	shrt
shoaly	shly
shoddily	shddly
shoe-horn	sh-hrn
shoehorn	shhrn
shoelace	shlc
shoemaker	shmkr
shoes	shs
shoestring	shstrng
shofar	shfr
shoofly	shfly
shootdown	shtdwn
shopper	shppr
shopping	shppng
shortage	shrtg
shortly	shrtly
shorts	shrts
shortwave	shrtwv
shoulder	shldr
shoutingly	shtngly
shovel	shvl
show	shw
shower	shwr
showily	shwly
shred	shrd
shrewdly	shrwdly
shrewly	shrwly
shriekily	shrkly
shrilly	shrlly
shrimp	shrmp
shrine	shrn
shyly	shyly
sibilantly	sblntly
sibling	sblng
sickerly	sckrly
sickishly	sckshly
sicklily	scklly
sickly	sckly
sideboard	sdbrd
sideburns	sdbrns
sidecar	sdcr
sidereally	sdrlly
sidestream	sdstrm
sidewalk	sdwlk
siding	sdng
sidlingly	sdlngly
sighfully	sghflly
sighingly	sghngly
sightlily	sghtlly
sightly	sghtly
sigmoidally	sgmdlly
sign	sgn
signal	sgnl
signally	sgnlly
signature	sgntr
signet	sgnt
significance	sgnfcnc
signup	sgnp
sikerly	skrly
silence	slnc
silently	slntly
silica	slc
silk	slk
silkworm	slkwrm
sill	sll
sillily	sllly
silo	sl
silver	slvr
silverly	slvrly
similarly	smlrly
simoniacally	smnclly
simply	smply
simulatively	smltvly
sincerely	sncrly
sinfully	snflly
singally	snglly
singeingly	sngngly
singer	sngr
single	sngl
singularly	snglrly
sinisterly	snstrly
sink	snk
sinlessly	snlssly
sinningly	snnngly
sinuously	snsly
sinusoidally	snsdlly
sippingly	sppngly
sirenically	srnclly
sister	sstr
sisterly	sstrly
sisters	sstrs
sixthly	sxthly
sizably	szbly
size	sz
skasely	sksly
skate	skt
skeely	skly
skelly	sklly
sketchily	sktchly
skewly	skwly
skiing	skng
skimpily	skmply
skin	skn
skirt	skrt
skull	skll
skullcap	skllcp
skunk	sknk
sky	sky
skylight	skylght
skywalk	skywlk
slangily	slngly
slapstick	slpstck
slash	slsh
slave	slv
slavishly	slvshly
sledge	sldg
sleepily	slply
sleet	slt
slenderly	slndrly
slicingly	slcngly
slickly	slckly
slidably	sldbly
slide	sld
slider	sldr
slidingly	sldngly
slightly	slghtly
slime	slm
slimily	slmly
slinkily	slnkly
slipper	slppr
slipperily	slpprly
slippers	slpprs
slope	slp
slopingly	slpngly
sloppily	slpply
sloth	slth
slouchily	slchly
slovenly	slvnly
slowbelly	slwblly
slowly	slwly
slubberly	slbbrly
slushily	slshly
sly	sly
slyly	slyly
smally	smlly
smartly	smrtly
smash	smsh
smell	smll
smelting	smltng
smile	sml
smilingly	smlngly
smirkly	smrkly
smock	smck
smog	smg
smoke	smk
smokily	smkly
smoking	smkng
smoothly	smthly
smudgedly	smdgdly
smudgily	smdgly
smuggling	smgglng
smugly	smgly
smuttily	smttly
snail	snl
snailishly	snlshly
snails	snls
snaily	snly
snakebite	snkbt
snakes	snks
snakily	snkly
snappily	snpply
snaringly	snrngly
snatchily	sntchly
sneakers	snkrs
sneakingly	snkngly
sneakishly	snkshly
sneeze	snz
snively	snvly
snob	snb
snodly	sndly
snootily	sntly
snorer	snrr
snottily	snttly
snow	snw
snowflake	snwflk
snowily	snwly
snowman	snwmn
snowplow	snwplw
snowstorm	snwstrm
snowsuit	snwst
snuffly	snffly
snuggle	snggl
snurly	snrly
soapbubbly	spbbbly
soapily	sply
soaringly	srngly
sobbingly	sbbngly
soberingly	sbrngly
soberly	sbrly
soccer	sccr
sociably	scbly
socially	sclly
societally	sctlly
society	scty
sociology	sclgy
socks	scks
soft	sft
softball	sftbll
softdrink	sftdrnk
softening	sftnng
softly	sftly
software	sftwr
soggily	sggly
soldierly	sldrly
solemnly	slmnly
solenoidally	slndlly
solicitously	slctsly
solidly	sldly
solitaire	sltr
solitarily	sltrly
solubly	slbly
solution	sltn
solvently	slvntly
somatically	smtclly
somberly	smbrly
sombrero	smbrr
sombrously	smbrsly
somersault	smrslt
somewhatly	smwhtly
somewhere	smwhr
son	sn
song	sng
songbird	sngbrd
songfully	sngflly
songs	sngs
sonnet	snnt
sonorously	snrsly
soodly	sdly
sophically	sphclly
soprano	sprn
sorbet	srbt
sorcerously	srcrsly
sordidly	srddly
soreheadedly	srhddly
sororially	srrlly
sorrily	srrly
sorrow	srrw
sort	srt
sortably	srtbly
sortly	srtly
sottishly	sttshly
soulfully	slflly
soullessly	sllssly
soulmate	slmt
soundingly	sndngly
soup	sp
sourbelly	srblly
source	src
sourishly	srshly
sourly	srly
sourwood	srwd
sousaphone	ssphn
south	sth
south america	sth mrc
south korea	sth kr
southerly	sthrly
southernly	sthrnly
sovereignly	svrgnly
soy	sy
soybean	sybn
sozzly	szzly
space	spc
spacing	spcng
spaciously	spcsly
spade	spd
spaghetti	spghtt
spandex	spndx
spanishly	spnshly
spank	spnk
spankily	spnkly
sparely	sprly
spark	sprk
sparkly	sprkly
sparrow	sprrw
sparsedly	sprsdly
spartanly	sprtnly
spasm	spsm
spatially	sptlly
speakably	spkbly
speaker	spkr
speakerphone	spkrphn
speakingly	spkngly
spear	spr
special	spcl
specialist	spclst
specially	spclly
specific	spcfc
specificly	spcfcly
speckly	spckly
spectacle	spctcl
spectacles	spctcls
specularly	spclrly
speech	spch
speedboat	spdbt
speedfully	spdflly
speedily	spdly
speedingly	spdngly
spell	spll
spelling	spllng
spend	spnd
sphere	sphr
sphynx	sphynx
spicily	spcly
spider	spdr
spiderly	spdrly
spiders	spdrs
spiffily	spffly
spike	spk
spilly	splly
spinach	spnch
spinally	spnlly
spindly	spndly
spinosely	spnsly
spinulosely	spnlsly
spiral	sprl
spirally	sprlly
spirit	sprt
spiritally	sprtlly
spiritual	sprtl
spirituously	sprtsly
spite	spt
spitefully	sptflly
split	splt
splurgily	splrgly
sponge	spng
spongily	spngly
spookily	spkly
spoon	spn
spooneyly	spnyly
sportively	sprtvly
spotlight	sptlght
spottedly	spttdly
spottily	spttly
spousally	spslly
sprackly	sprckly
spraggly	sprggly
sprawly	sprwly
spread	sprd
spring	sprng
sprinter	sprntr
spruce	sprc
sprucely	sprcly
spruntly	sprntly
spryly	spryly
spume	spm
spy	spy
squabbly	sqbbly
squalidly	sqldly
squally	sqlly
squamously	sqmsly
square	sqr
squaredly	sqrdly
squarely	sqrly
squarishly	sqrshly
squarrosely	sqrrsly
squash	sqsh
squashily	sqshly
squatly	sqtly
squatter	sqttr
squattily	sqttly
squeakily	sqkly
squeakingly	sqkngly
squeamishly	sqmshly
squeegee	sqg
squeezably	sqzbly
squeezingly	sqzngly
squelchily	sqlchly
squid	sqd
squiggly	sqggly
squintly	sqntly
squirrel	sqrrl
stable	stbl
stably	stbly
stadium	stdm
staff	stff
stag	stg
stageably	stgbly
stagily	stgly
stain	stn
stainably	stnbly
staircase	strcs
stalkily	stlkly
stallion	stlln
stamina	stmn
stamp	stmp
stance	stnc
stand	stnd
standard	stndrd
standoff	stndff
stanly	stnly
starchly	strchly
starkly	strkly
starrily	strrly
starter	strtr
starvedly	strvdly
statedly	sttdly
statefully	sttflly
statelily	sttlly
statement	sttmnt
statically	sttclly
station	sttn
stationarily	sttnrly
statistic	sttstc
statuesquely	sttsqly
status	stts
statutably	stttbly
statutorily	stttrly
staunchly	stnchly
stay	sty
steadily	stdly
steak	stk
stealingly	stlngly
stealthily	stlthly
steam	stm
steamily	stmly
steamroller	stmrllr
steeple	stpl
steeply	stply
steevely	stvly
stellately	stlltly
stencil	stncl
step	stp
step-aunt	stp-nt
step-son	stp-sn
step-uncle	stp-ncl
stepmother	stpmthr
steps	stps
stepson	stpsn
sternly	strnly
stew	stw
stick	stck
sticks	stcks
stiffly	stffly
stifledly	stfldly
stiletto	stltt
still	stll
stilly	stlly
stinger	stngr
stingily	stngly
stintedly	stntdly
stipply	stpply
stitch	sttch
stockily	stckly
stocking	stckng
stockings	stckngs
stodgily	stdgly
stoically	stclly
stolenly	stlnly
stolidly	stldly
stomach	stmch
stonewally	stnwlly
stonework	stnwrk
stonily	stnly
stool	stl
stoopingly	stpngly
stoppably	stppbly
stopsign	stpsgn
stopwatch	stpwtch
storage	strg
storm	strm
stormily	strmly
storyboard	strybrd
stove	stv
straggly	strggly
strain	strn
strainably	strnbly
strainedly	strndly
strait	strt
straitly	strtly
strangely	strngly
stranger	strngr
strap	strp
strategy	strtgy
straw	strw
streakedly	strkdly
streckly	strckly
streetcar	strtcr
strength	strngth
strenuously	strnsly
stress	strss
stretch	strtch
strictly	strctly
strike	strk
string	strng
strubbly	strbbly
structure	strctr
struggle	strggl
stubbly	stbbly
stud	std
student	stdnt
studiedly	stddly
studiously	stdsly
study	stdy
stumbling	stmblng
stumpily	stmply
stupendly	stpndly
stupid	stpd
stupidity	stpdty
stupidly	stpdly
sturdily	strdly
style	styl
styling	stylng
stylus	styls
suasively	ssvly
suavely	svly
subacidly	sbcdly
subacutely	sbctly
subaerially	sbrlly
subconscious	sbcnscs
subdolously	sbdlsly
subduably	sbdbly
subduedly	sbddly
subduingly	sbdngly
subdurally	sbdrlly
subequally	sbqlly
subfamily	sbfmly
subgwely	sbgwly
subject	sbjct
sublimely	sblmly
submarine	sbmrn
submissly	sbmssly
subroutine	sbrtn
subsidence	sbsdnc
subsidiarily	sbsdrly
substance	sbstnc
subtilely	sbtlly
subtly	sbtly
suburb	sbrb
suburbanly	sbrbnly
subway	sbwy
success	sccss
suck	sck
suddenly	sddnly
sufferably	sffrbly
suffocation	sffctn
suffusedly	sffsdly
sugar	sgr
sugarelly	sgrlly
suggestion	sggstn
suicidally	scdlly
suitcase	stcs
sulfureously	slfrsly
sulkily	slkly
sullenly	sllnly
summer	smmr
summerly	smmrly
sumptuously	smptsly
sunbeam	snbm
sunbonnet	snbnnt
sunday	sndy
sundial	sndl
sundrily	sndrly
sunflower	snflwr
sunglasses	snglsss
sunlamp	snlmp
sunnily	snnly
sunroom	snrm
sunshine	snshn
superbly	sprbly
superfamily	sprfmly
superfolly	sprflly
superimply	sprmply
superiorly	sprrly
supermanly	sprmnly
supermarket	sprmrkt
supernally	sprnlly
superugly	sprgly
supinely	spnly
supplely	spplly
supply	spply
support	spprt
supporter	spprtr
supposably	sppsbly
supposedly	sppsdly
suppression	spprssn
supremely	sprmly
surface	srfc
surfacedly	srfcdly
surfacely	srfcly
surfboard	srfbrd
surgeon	srgn
surgery	srgry
surgically	srgclly
surlily	srlly
surmisedly	srmsdly
surname	srnm
surprise	srprs
surround	srrnd
survey	srvy
suspect	sspct
suspenders	sspndrs
suspensely	sspnsly
suspiciously	sspcsly
sustainment	sstnmnt
sustanedly	sstndly
suturally	strlly
suv	sv
swabberly	swbbrly
swagbelly	swgblly
swalingly	swlngly
swallow	swllw
swamp	swmp
swan	swn
swankily	swnkly
swarthily	swrthly
swartly	swrtly
swath	swth
swayingly	swyngly
swearingly	swrngly
sweat	swt
sweater	swtr
sweatily	swtly
sweats	swts
sweatshirt	swtshrt
sweatshop	swtshp
sweatsuit	swtst
swedish	swdsh
sweepingly	swpngly
sweetishly	swtshly
swell	swll
swelly	swlly
swervily	swrvly
swim	swm
swimmily	swmmly
swimming	swmmng
swimsuit	swmst
swinely	swnly
swing	swng
swinishly	swnshly
swirly	swrly
swiss	swss
switch	swtch
swivel	swvl
swollenly	swllnly
swooningly	swnngly
sword	swrd
swordfish	swrdfsh
sycamore	sycmr
sylvanly	sylvnly
symmetry	symmtry
sympathy	sympthy
symphily	symphly
syndicate	syndct
synergy	synrgy
synod	synd
synodally	syndlly
synoeciously	syncsly
synovially	synvlly
syrup	syrp
system	systm
t-shirt	t-shrt
tabby	tbby
tabernacle	tbrncl
tabidly	tbdly
table	tbl
tablecloth	tblclth
tabletop	tbltp
tabularly	tblrly
tachometer	tchmtr
tacitly	tctly
taciturnly	tctrnly
tackingly	tckngly
tackle	tckl
tactfully	tctflly
tactically	tctclly
tactually	tctlly
tadpole	tdpl
tail	tl
taillessly	tllssly
tailorly	tlrly
tailspin	tlspn
takingly	tkngly
talk	tlk
talkatively	tlktvly
tambourine	tmbrn
tandem	tndm
tangently	tngntly
tangerine	tngrn
tangibly	tngbly
tank	tnk
tank-top	tnk-tp
tanker	tnkr
tankful	tnkfl
taperingly	tprngly
taperly	tprly
tapsterly	tpstrly
tard	trd
target	trgt
tarrily	trrly
tartarly	trtrly
tartishly	trtshly
tartly	trtly
task	tsk
tassely	tssly
tastably	tstbly
taste	tst
tastefully	tstflly
tastingly	tstngly
tatami	ttm
tatteredly	tttrdly
tatterly	tttrly
tattler	tttlr
tattoo	ttt
tauntingly	tntngly
tautly	ttly
tautologously	ttlgsly
tavern	tvrn
tavernly	tvrnly
tawdrily	twdrly
taxably	txbly
taxatively	txtvly
taxi	tx
taxicab	txcb
taxingly	txngly
taxlessly	txlssly
teachably	tchbly
teacher	tchr
teacherly	tchrly
teaching	tchng
teachingly	tchngly
tear	tr
tearably	trbly
tearfully	trflly
teaseably	tsbly
teasingly	tsngly
techily	tchly
technology	tchnlgy
tediously	tdsly
teemingly	tmngly
teeth	tth
teethily	tthly
teetotally	tttlly
tegularly	tglrly
telephone	tlphn
telescreen	tlscrn
teletype	tltyp
television	tlvsn
telically	tlclly
teller	tllr
tellingly	tllngly
telltalely	tlltlly
temerariously	tmrrsly
temerously	tmrsly
temper	tmpr
temperably	tmprbly
temperately	tmprtly
temperature	tmprtr
temperedly	tmprdly
temple	tmpl
tempo	tmp
temporally	tmprlly
temporarily	tmprrly
temporary	tmprry
temprely	tmprly
temptress	tmptrss
temulently	tmlntly
tenably	tnbly
tenaciously	tncsly
tendency	tndncy
tenderably	tndrbly
tenderly	tndrly
tendingly	tndngly
tendrilly	tndrlly
tenebrously	tnbrsly
tenement	tnmnt
tennis	tnns
tenor	tnr
tensely	tnsly
tensibly	tnsbly
tensilely	tnslly
tension	tnsn
tent	tnt
tentatively	tnttvly
tenthly	tnthly
tenurially	tnrlly
tepidly	tpdly
terminably	trmnbly
terminally	trmnlly
termly	trmly
terracotta	trrctt
terrapin	trrpn
terrenely	trrnly
terribly	trrbly
terrificly	trrfcly
terrifiedly	trrfdly
territory	trrtry
tersely	trsly
testily	tstly
tetanically	ttnclly
teutonically	ttnclly
tewly	twly
text	txt
textbook	txtbk
textually	txtlly
texturally	txtrlly
texture	txtr
thanks	thnks
thaw	thw
theater	thtr
theftuously	thftsly
thegnly	thgnly
theism	thsm
theme	thm
theorically	thrclly
theory	thry
therapist	thrpst
thereckly	thrckly
thermally	thrmlly
thermals	thrmls
thermometer	thrmmtr
thetically	thtclly
thickly	thckly
thievingly	thvngly
thievishly	thvshly
thigh	thgh
thilly	thlly
thingly	thngly
things	thngs
thinkably	thnkbly
thinking	thnkng
thinly	thnly
thirdly	thrdly
thirst	thrst
thirstily	thrstly
thistle	thstl
thistly	thstly
thomas	thms
thong	thng
thorn	thrn
thornily	thrnly
thoroughly	thrghly
thought	thght
thread	thrd
thriftily	thrftly
thrill	thrll
thrilly	thrlly
thrioboly	thrbly
throat	thrt
throatily	thrtly
thrush	thrsh
thumb	thmb
thunder	thndr
thunderhead	thndrhd
thusly	thsly
thwartly	thwrtly
tic	tc
ticket	tckt
ticklely	tcklly
tickly	tckly
tidally	tdlly
tidily	tdly
tiger	tgr
tigerishly	tgrshly
tigerly	tgrly
tight	tght
tightly	tghtly
tights	tghts
till	tll
tilly	tlly
timbale	tmbl
timber	tmbr
timefully	tmflly
timelessly	tmlssly
timelily	tmlly
timeline	tmln
timely	tmly
timeously	tmsly
timeout	tmt
timer	tmr
timidly	tmdly
timpani	tmpn
tinderbox	tndrbx
tingly	tngly
tinily	tnly
tinkerly	tnkrly
tinkle	tnkl
tinkly	tnkly
tinnily	tnnly
tintype	tntyp
tipply	tpply
tipsily	tpsly
tiptoeingly	tptngly
tirelessly	trlssly
tiresomely	trsmly
tiringly	trngly
tissue	tss
titanium	ttnm
titubantly	ttbntly
titularly	ttlrly
toad	td
today	tdy
toe	t
toenail	tnl
toes	ts
toga	tg
togs	tgs
toilet	tlt
toilfully	tlflly
toilingly	tlngly
toilsomely	tlsmly
tolerably	tlrbly
tolerance	tlrnc
tolerantly	tlrntly
tom-tom	tm-tm
tomatoes	tmts
tomography	tmgrphy
tomorrow	tmrrw
tone	tn
tonelessly	tnlssly
tonetically	tntclly
tongue	tng
tonically	tnclly
tonight	tnght
tonishly	tnshly
tonnishly	tnnshly
toothbrush	tthbrsh
toothpaste	tthpst
toothpick	tthpck
toothsomely	tthsmly
top	tp
top-hat	tp-ht
topic	tpc
topically	tpclly
toploftily	tplftly
topmostly	tpmstly
toppingly	tppngly
topsail	tpsl
toque	tq
torchiere	trchr
toreador	trdr
tornado	trnd
torridly	trrdly
torsionally	trsnlly
torso	trs
tortellini	trtlln
tortoise	trts
tortuously	trtsly
torturedly	trtrdly
torturously	trtrsly
toshly	tshly
tosily	tsly
tosser	tssr
tossingly	tssngly
total	ttl
totally	ttlly
tote	tt
totemically	ttmclly
touch	tch
tough	tgh
tough-guy	tgh-gy
toughly	tghly
tow-truck	tw-trck
towardly	twrdly
towel	twl
tower	twr
toweringly	twrngly
town	twn
townhouse	twnhs
townishly	twnshly
townly	twnly
toxically	txclly
toxophily	txphly
toy	ty
toyingly	tyngly
toyishly	tyshly
toys	tys
traceably	trcbly
trachoma	trchm
tracingly	trcngly
tracksuit	trckst
tractably	trctbly
tractor	trctr
tradition	trdtn
traffic	trffc
tragically	trgclly
tragicly	trgcly
trail	trl
trailer	trlr
trailingly	trlngly
trainer	trnr
training	trnng
trains	trns
tramp	trmp
trancedly	trncdly
tranquilly	trnqlly
transaction	trnsctn
transition	trnstn
translation	trnsltn
transom	trnsm
transport	trnsprt
trapdoor	trpdr
trapezium	trpzm
trapezoid	trpzd
trash	trsh
trashily	trshly
travel	trvl
traversely	trvrsly
treacly	trcly
treasonably	trsnbly
treasonously	trsnsly
treat	trt
treatably	trtbly
treatment	trtmnt
trellis	trlls
trembly	trmbly
tremor	trmr
tremulously	trmlsly
trench	trnch
triadically	trdclly
triangle	trngl
tribally	trblly
tribe	trb
tributarily	trbtrly
trickily	trckly
tricksily	trcksly
triedly	trdly
triennially	trnnlly
trifoly	trfly
trigly	trgly
trigonally	trgnlly
trihourly	trhrly
trinely	trnly
trinket	trnkt
trinomially	trnmlly
trip	trp
triply	trply
tripod	trpd
tripsomely	trpsmly
triradially	trrdlly
triradiately	trrdtly
triserially	trsrlly
tritically	trtclly
trivantly	trvntly
trivially	trvlly
triweekly	trwkly
trolly	trlly
trombone	trmbn
trooper	trpr
tropically	trpclly
trouble	trbl
troubledly	trbldly
troublously	trblsly
trousers	trsrs
trove	trv
trowel	trwl
truantly	trntly
truck	trck
truckit	trckt
trucks	trcks
trumpet	trmpt
truncately	trnctly
trunk	trnk
trust	trst
trustably	trstbly
trustily	trstly
truth	trth
try	try
tryingly	tryngly
tsunami	tsnm
tub	tb
tuberously	tbrsly
tubulously	tblsly
tuftily	tftly
tugboat	tgbt
tuggingly	tggngly
tulip	tlp
tumbly	tmbly
tummy	tmmy
tumultuarily	tmltrly
tumultuously	tmltsly
tunbelly	tnblly
tune-up	tn-p
tunefully	tnflly
tunic	tnc
tunnel	tnnl
tunnelly	tnnlly
turban	trbn
turbidly	trbdly
turgently	trgntly
turgidly	trgdly
turkey	trky
turkish	trksh
turkishly	trkshly
turn	trn
turnip	trnp
turnover	trnvr
turnstile	trnstl
turpidly	trpdly
turret	trrt
turtle	trtl
tussle	tssl
tutorially	ttrlly
tuxedo	txd
tv	tv
twarly	twrly
twiddly	twddly
twifoldly	twfldly
twig	twg
twilight	twlght
twilly	twlly
twiningly	twnngly
twinkly	twnkly
twist	twst
twistedly	twstdly
twister	twstr
twistily	twstly
twitchily	twtchly
twitterly	twttrly
two	tw
type	typ
typewriter	typwrtr
typhoon	typhn
typically	typclly
tyvek	tyvk
uberously	brsly
ubiquitously	bqtsly
uglily	glly
ugly	gly
ugsomely	gsmly
ulcerously	lcrsly
ulteriorly	ltrrly
ultimately	ltmtly
ultraugly	ltrgly
ultroneously	ltrnsly
umbellately	mblltly
umbilically	mblclly
umbrageously	mbrgsly
umbrally	mbrlly
umbrella	mbrll
unabashedly	nbshdly
unabatedly	nbtdly
unabatingly	nbtngly
unabidingly	nbdngly
unably	nbly
unaccurately	nccrtly
unaccusably	nccsbly
unacquirably	ncqrbly
unactually	nctlly
unacutely	nctly
unadaptably	ndptbly
unadaptedly	ndptdly
unadornedly	ndrndly
unadversely	ndvrsly
unadvisably	ndvsbly
unaffably	nffbly
unagitatedly	ngttdly
unagreeably	ngrbly
unaidedly	nddly
unalertly	nlrtly
unallayably	nllybly
unalleviably	nllvbly
unalliedly	nlldly
unallowedly	nllwdly
unalterably	nltrbly
unamazedly	nmzdly
unambiguously	nmbgsly
unambitiously	nmbtsly
unamenably	nmnbly
unamendedly	nmnddly
unamicably	nmcbly
unamply	nmply
unamusably	nmsbly
unamusingly	nmsngly
unanalogously	nnlgsly
unangrily	nngrly
unanimatedly	nnmtdly
unanimously	nnmsly
unannexedly	nnnxdly
unappeasably	nppsbly
unappliably	npplbly
unarmedly	nrmdly
unartfully	nrtflly
unashamedly	nshmdly
unassailably	nsslbly
unassociably	nsscbly
unassuredly	nssrdly
unattainably	nttnbly
unauspiciously	nspcsly
unavailingly	nvlngly
unavertibly	nvrtbly
unavoidably	nvdbly
unavouchably	nvchbly
unavowably	nvwbly
unavowedly	nvwdly
unawfully	nwflly
unbankably	nbnkbly
unbearably	nbrbly
unbeatably	nbtbly
unbeauteously	nbtsly
unbeautifully	nbtflly
unbelievably	nblvbly
unbenignly	nbngnly
unbeseemly	nbsmly
unbiasedly	nbsdly
unbirdly	nbrdly
unbishoply	nbshply
unblamably	nblmbly
unblinking	nblnkng
unblithely	nblthly
unbodily	nbdly
unboldly	nbldly
unboundably	nbndbly
unboundedly	nbnddly
unbravely	nbrvly
unbribably	nbrbbly
unbriefly	nbrfly
unbrokenly	nbrknly
unbrookably	nbrkbly
unbudgeably	nbdgbly
unburly	nbrly
unbusily	nbsly
unbuxomly	nbxmly
uncalmly	nclmly
uncandidly	ncnddly
uncannily	ncnnly
uncapably	ncpbly
uncaptiously	ncptsly
uncarefully	ncrflly
uncausatively	ncstvly
uncautiously	nctsly
uncavalierly	ncvlrly
unceasingly	ncsngly
uncertainly	ncrtnly
uncharily	nchrly
unchastely	nchstly
unchoicely	nchcly
uncially	nclly
uncitizenly	nctznly
uncivilly	ncvlly
uncle	ncl
uncleanlily	nclnlly
uncleanly	nclnly
unclerkly	nclrkly
uncleverly	nclvrly
uncloudedly	nclddly
uncolorably	nclrbly
uncoloredly	nclrdly
uncoly	ncly
uncomelily	ncmlly
uncomely	ncmly
uncommonly	ncmmnly
uncordially	ncrdlly
uncostly	ncstly
uncountably	ncntbly
uncousinly	ncsnly
uncouthly	ncthly
uncoveredly	ncvrdly
uncraftily	ncrftly
uncreaturely	ncrtrly
uncredibly	ncrdbly
uncrossly	ncrssly
uncurably	ncrbly
uncurbedly	ncrbdly
uncuriously	ncrsly
undeceivably	ndcvbly
undecidedly	ndcddly
undecorously	ndcrsly
undeemously	ndmsly
undefeatedly	ndftdly
undefiledly	ndfldly
undefinedly	ndfndly
undelayedly	ndlydly
undelusively	ndlsvly
undeniably	ndnbly
undeniedly	ndndly
underbelly	ndrblly
underground	ndrgrnd
underivedly	ndrvdly
underly	ndrly
underneath	ndrnth
underpants	ndrpnts
underpass	ndrpss
underply	ndrply
undersally	ndrslly
undershirt	ndrshrt
underwire	ndrwr
undesirably	ndsrbly
undesiredly	ndsrdly
undesirously	ndsrsly
undeviously	ndvsly
undevoutly	ndvtly
undirectly	ndrctly
undividably	ndvdbly
undividedly	ndvddly
undivinely	ndvnly
undoubtedly	ndbtdly
undubitably	ndbtbly
undularly	ndlrly
undulately	ndltly
undutifully	ndtflly
undyingly	ndyngly
unearthly	nrthly
uneducably	ndcbly
uneducatedly	ndctdly
uneffaceably	nffcbly
unelaborately	nlbrtly
unelegantly	nlgntly
uneminently	nmnntly
unemotionally	nmtnlly
unendingly	nndngly
unendurably	nndrbly
unenviably	nnvbly
unenviedly	nnvdly
unenviously	nnvsly
unequably	nqbly
unequally	nqlly
unequivocally	nqvclly
unerroneously	nrrnsly
unestimably	nstmbly
unethically	nthclly
uneuphoniously	nphnsly
unevenly	nvnly
unevitably	nvtbly
unexactedly	nxctdly
unexcusedly	nxcsdly
unfadingly	nfdngly
unfailably	nflbly
unfailingly	nflngly
unfairly	nfrly
unfallibly	nfllbly
unfamiliarly	nfmlrly
unfatherly	nfthrly
unfavorably	nfvrbly
unfearfully	nfrflly
unfearingly	nfrngly
unfeignably	nfgnbly
unfeignedly	nfgndly
unfellowly	nfllwly
unfeloniously	nflnsly
unfemininely	nfmnnly
unfestively	nfstvly
unfilially	nfllly
unfitly	nftly
unfleshly	nflshly
unforcibly	nfrcbly
unforeseeably	nfrsbly
unforeseenly	nfrsnly
unfoundedly	nfnddly
unframably	nfrmbly
unfrankly	nfrnkly
unfriendly	nfrndly
unfrugally	nfrglly
unfully	nflly
unfunnily	nfnnly
unfusibly	nfsbly
ungainfully	ngnflly
ungainly	ngnly
ungainsomely	ngnsmly
ungenerously	ngnrsly
ungenially	ngnlly
ungenteelly	ngntlly
ungently	ngntly
ungenuinely	ngnnly
unghostly	nghstly
ungladly	ngldly
unglossily	nglssly
ungodlily	ngdlly
ungodly	ngdly
ungraciously	ngrcsly
ungradually	ngrdlly
ungravelly	ngrvlly
ungravely	ngrvly
ungreatly	ngrtly
unguardedly	ngrddly
unguidably	ngdbly
unguidedly	ngddly
unguilefully	nglflly
unguiltily	ngltly
unhabitually	nhbtlly
unhairily	nhrly
unhandily	nhndly
unhappily	nhpply
unhardily	nhrdly
unhastily	nhstly
unhatingly	nhtngly
unhealably	nhlbly
unhealthily	nhlthly
unheavenly	nhvnly
unheavily	nhvly
unheededly	nhddly
unheedfully	nhdflly
unheedingly	nhdngly
unheroically	nhrclly
unhidably	nhdbly
unholily	nhlly
unholy	nhly
unhomely	nhmly
unhonestly	nhnstly
unhonorably	nhnrbly
unhopedly	nhpdly
unhopefully	nhpflly
unhopingly	nhpngly
unhostilely	nhstlly
unhousewifely	nhswfly
unhumbly	nhmbly
unhumorously	nhmrsly
unhurriedly	nhrrdly
uniambically	nmbclly
unicursally	ncrslly
unifiedly	nfdly
uniform	nfrm
unilludedly	nllddly
unimaginably	nmgnbly
unimitably	nmtbly
unimpededly	nmpddly
unimposedly	nmpsdly
uningeniously	nngnsly
uninjuriously	nnjrsly
unintently	nntntly
uninvidiously	nnvdsly
uninvitedly	nnvtdly
unique	nq
uniquely	nqly
uniserially	nsrlly
uniseriately	nsrtly
unisexually	nsxlly
unisonally	nsnlly
unitarily	ntrly
unitingly	ntngly
unitively	ntvly
unity	nty
universally	nvrslly
university	nvrsty
univocally	nvclly
unjokingly	njkngly
unjovially	njvlly
unjoyfully	njyflly
unjoyously	njysly
unjudicially	njdclly
unjudiciously	njdcsly
unjustly	njstly
unkemptly	nkmptly
unkindlily	nkndlly
unkindly	nkndly
unkingly	nkngly
unknowably	nknwbly
unknownly	nknwnly
unlaboriously	nlbrsly
unlaudably	nldbly
unlawfully	nlwflly
unleaderly	nldrly
unlearnedly	nlrndly
unlegally	nlglly
unleisurely	nlsrly
unlikably	nlkbly
unlikely	nlkly
unlimitably	nlmtbly
unlimitedly	nlmtdly
unliterally	nltrlly
unloanably	nlnbly
unloathly	nlthly
unlocally	nlclly
unlogically	nlgclly
unlonely	nlnly
unloosably	nlsbly
unlordly	nlrdly
unlovably	nlvbly
unlovelily	nlvlly
unlovely	nlvly
unloverly	nlvrly
unlovingly	nlvngly
unlowly	nlwly
unloyally	nlylly
unluckily	nlckly
unlustily	nlstly
unmackly	nmckly
unmaidenly	nmdnly
unmanageably	nmngbly
unmanfully	nmnflly
unmanly	nmnly
unmannerly	nmnnrly
unmaturely	nmtrly
unmeaningly	nmnngly
unmeasurably	nmsrbly
unmeasuredly	nmsrdly
unmeekly	nmkly
unmelodiously	nmldsly
unmeltably	nmltbly
unmendably	nmndbly
unmeritedly	nmrtdly
unmilitarily	nmltrly
unmiserly	nmsrly
unmixedly	nmxdly
unmoderately	nmdrtly
unmodifiably	nmdfbly
unmonkly	nmnkly
unmorally	nmrlly
unmotherly	nmthrly
unmovably	nmvbly
unmovedly	nmvdly
unmovingly	nmvngly
unmultiply	nmltply
unmusically	nmsclly
unmusicianly	nmscnly
unnamably	nnmbly
unnavigably	nnvgbly
unnearly	nnrly
unneedfully	nndflly
unnegotiably	nngtbly
unnewly	nnwly
unnicely	nncly
unnobly	nnbly
unnoticeably	nntcbly
unobediently	nbdntly
unobsequiously	nbsqsly
unobtainably	nbtnbly
unoccupiedly	nccpdly
unofficially	nffclly
unoily	nly
unopenly	npnly
unoperably	nprbly
unopposedly	nppsdly
unorderly	nrdrly
unordinarily	nrdnrly
unordinately	nrdntly
unoriginally	nrgnlly
unoriginately	nrgntly
unornly	nrnly
unpacifiedly	npcfdly
unpaintably	npntbly
unpaintedly	npntdly
unpalatably	npltbly
unpartably	nprtbly
unpartially	nprtlly
unpassably	npssbly
unpatiently	nptntly
unpausingly	npsngly
unpayably	npybly
unpeaceably	npcbly
unpeacefully	npcflly
unpecuniarily	npcnrly
unpiteously	nptsly
unpitiably	nptbly
unpitiedly	nptdly
unpitifully	nptflly
unplacably	nplcbly
unplainly	nplnly
unplausibly	nplsbly
unpliably	nplbly
unpliantly	nplntly
unpoetically	nptclly
unpolitely	npltly
unpoliticly	npltcly
unpopularly	npplrly
unportly	nprtly
unprecisely	nprcsly
unpriceably	nprcbly
unprickly	nprckly
unpriestly	nprstly
unprincely	nprncly
unprofusely	nprfsly
unproperly	nprprly
unprovably	nprvbly
unpurely	nprly
unpurposely	nprpsly
unquailingly	nqlngly
unquakerly	nqkrly
unqualifiedly	nqlfdly
unqueenly	nqnly
unquickly	nqckly
unquietly	nqtly
unreachably	nrchbly
unreadily	nrdly
unreally	nrlly
unreasonably	nrsnbly
unrebukably	nrbkbly
unredeemably	nrdmbly
unredeemedly	nrdmdly
unreducibly	nrdcbly
unrefinedly	nrfndly
unrefusably	nrfsbly
unregally	nrglly
unrelatively	nrltvly
unreliably	nrlbly
unrelievedly	nrlvdly
unreligiously	nrlgsly
unremotely	nrmtly
unremovably	nrmvbly
unrepealably	nrplbly
unrequitedly	nrqtdly
unrevocably	nrvcbly
unridably	nrdbly
unrightly	nrghtly
unripely	nrply
unrivaledly	nrvldly
unroyally	nrylly
unruledly	nrldly
unsafely	nsfly
unsaintly	nsntly
unsanguinely	nsngnly
unsatedly	nstdly
unsavorily	nsvrly
unscalably	nsclbly
unscaly	nscly
unseasonably	nssnbly
unsecretly	nscrtly
unsecuredly	nscrdly
unsecurely	nscrly
unseeingly	nsngly
unseemingly	nsmngly
unseemlily	nsmlly
unseemly	nsmly
unsensibly	nsnsbly
unsensually	nsnslly
unseveredly	nsvrdly
unshakeably	nshkbly
unshakenly	nshknly
unshamably	nshmbly
unshapely	nshply
unshapenly	nshpnly
unshavedly	nshvdly
unshavenly	nshvnly
unshyly	nshyly
unsickerly	nsckrly
unsickly	nsckly
unsightly	nsghtly
unsilently	nslntly
unsilly	nslly
unsimilarly	nsmlrly
unsincerely	nsncrly
unsinfully	nsnflly
unsisterly	nsstrly
unsleepably	nslpbly
unsly	nsly
unsmartly	nsmrtly
unsmoothly	nsmthly
unsoberly	nsbrly
unsociably	nscbly
unsocially	nsclly
unsoldierly	nsldrly
unsolemnly	nslmnly
unsolidly	nsldly
unsoulfully	nslflly
unsoundly	nsndly
unspeakably	nspkbly
unspoilably	nsplbly
unspokenly	nspknly
unstainedly	nstndly
unstoically	nstclly
unsubduably	nsbdbly
unsubduedly	nsbddly
unsubtly	nsbtly
unsulliedly	nslldly
unsummerly	nsmmrly
unsweetly	nswtly
untailorly	ntlrly
untaintedly	ntntdly
untamedly	ntmdly
untangibly	ntngbly
untellably	ntllbly
untenably	ntnbly
untenderly	ntndrly
unterribly	ntrrbly
untholeably	nthlbly
untidily	ntdly
untimely	ntmly
untimeously	ntmsly
untiredly	ntrdly
untiringly	ntrngly
untolerably	ntlrbly
untouchably	ntchbly
untowardly	ntwrdly
untraceably	ntrcbly
untrainedly	ntrndly
untreatably	ntrtbly
untunefully	ntnflly
untutoredly	nttrdly
unugly	ngly
ununanimously	nnnmsly
ununiformly	nnfrmly
ununitably	nntbly
unusably	nsbly
unutterably	nttrbly
unvalidly	nvldly
unvaluably	nvlbly
unvariably	nvrbly
unvariedly	nvrdly
unverifiably	nvrfbly
unvicariously	nvcrsly
unvigorously	nvgrsly
unvirtuously	nvrtsly
unvitiatedly	nvttdly
unvouchedly	nvchdly
unvulgarly	nvlgrly
unwaggably	nwggbly
unwarily	nwrly
unwarnedly	nwrndly
unweariably	nwrbly
unweatherly	nwthrly
unweddedly	nwdddly
unweetingly	nwtngly
unwelcomely	nwlcmly
unwieldily	nwldly
unwifely	nwfly
unwilily	nwlly
unwisely	nwsly
unwittily	nwttly
unwomanly	nwmnly
unwontedly	nwntdly
unwordably	nwrdbly
unworkably	nwrkbly
unworldly	nwrldly
unworriedly	nwrrdly
unworthily	nwrthly
unzealously	nzlsly
upfly	pfly
upgully	pglly
upliftedly	plftdly
upper	ppr
uppishly	ppshly
uprightly	prghtly
uproariously	prrsly
upstairs	pstrs
upwardly	pwrdly
urbanely	rbnly
urchinly	rchnly
urgently	rgntly
urgingly	rgngly
urn	rn
usage	sg
uselessly	slssly
user	sr
usher	shr
usurpatively	srptvly
usurpedly	srpdly
usurpingly	srpngly
utensil	tnsl
utilitarianly	tltrnly
utterly	ttrly
uvularly	vlrly
uxorially	xrlly
uxoriously	xrsly
vacantly	vcntly
vacuum	vcm
vagariously	vgrsly
vagrant	vgrnt
vagrantly	vgrntly
vaguely	vgly
valance	vlnc
validity	vldty
valley	vlly
valorously	vlrsly
valuable	vlbl
vanity	vnty
vapidly	vpdly
vaporingly	vprngly
vaporously	vprsly
variably	vrbly
variation	vrtn
variatively	vrtvly
varietally	vrtlly
variety	vrty
variformly	vrfrmly
varyingly	vryngly
vascularly	vsclrly
vase	vs
vastly	vstly
vatically	vtclly
vault	vlt
vaultedly	vltdly
vaulting	vltng
vauntingly	vntngly
vealy	vly
vectorially	vctrlly
veeringly	vrngly
vegetable	vgtbl
vegetably	vgtbly
vegetarianism	vgtrnsm
vegetation	vgttn
vegetatively	vgttvly
vehemently	vhmntly
vehicle	vhcl
vehicularly	vhclrly
veil	vl
veiledly	vldly
veldt	vldt
vellum	vllm
velodrome	vldrm
velvet	vlvt
venatically	vntclly
vendibly	vndbly
venerably	vnrbly
veneratively	vnrtvly
vengeance	vngnc
vengefully	vngflly
vengeously	vngsly
venially	vnlly
venom	vnm
venomly	vnmly
venomously	vnmsly
ventrally	vntrlly
venturously	vntrsly
veranda	vrnd
verbally	vrblly
verbosely	vrbsly
verdict	vrdct
veridically	vrdclly
verifiably	vrfbly
veritably	vrtbly
vermicelli	vrmcll
verminly	vrmnly
verminously	vrmnsly
vernally	vrnlly
versatilely	vrstlly
verse	vrs
version	vrsn
vertically	vrtclly
vertigo	vrtg
verve	vrv
vessel	vssl
vestigially	vstglly
vestment	vstmnt
vexatiously	vxtsly
vexedly	vxdly
vexingly	vxngly
viatorially	vtrlly
vibe	vb
vibrantly	vbrntly
vibraphone	vbrphn
vibration	vbrtn
vicariously	vcrsly
vicarly	vcrly
viceregally	vcrglly
viciously	vcsly
victorianly	vctrnly
victoriously	vctrsly
video	vd
vidually	vdlly
view	vw
viewlessly	vwlssly
vigilantly	vglntly
villa	vll
village	vllg
villainously	vllnsly
villously	vllsly
vindicably	vndcbly
vineyard	vnyrd
vinously	vnsly
vinyl	vnyl
violaceously	vlcsly
violently	vlntly
violin	vln
viperishly	vprshly
virginal	vrgnl
virginally	vrgnlly
virginly	vrgnly
virilely	vrlly
viriliously	vrlsly
virtue	vrt
virtuously	vrtsly
virulently	vrlntly
viscerally	vscrlly
viscidly	vscdly
viscose	vscs
viscously	vscsly
visibly	vsbly
vision	vsn
visionally	vsnlly
visionarily	vsnrly
visit	vst
visitor	vstr
visor	vsr
visual	vsl
visually	vslly
vitality	vtlty
vitally	vtlly
vitreously	vtrsly
vivaciously	vvcsly
vively	vvly
vividly	vvdly
viviparously	vvprsly
vixen	vxn
vixenishly	vxnshly
vixenly	vxnly
vocably	vcbly
vocally	vclly
vocationally	vctnlly
vocatively	vctvly
vociferously	vcfrsly
voice	vc
voicelessly	vclssly
voidly	vdly
volatilely	vltlly
volcano	vlcn
volitionally	vltnlly
volleyball	vllybll
volubly	vlbly
volume	vlm
voluminously	vlmnsly
voluntarily	vlntrly
voluptuously	vlptsly
vomitingly	vmtngly
vorticosely	vrtcsly
votively	vtvly
vowely	vwly
voyage	vyg
vulgarly	vlgrly
vulnerably	vlnrbly
vyingly	vyngly
wad	wd
waddly	wddly
wadingly	wdngly
wafer	wfr
waffle	wffl
waffly	wffly
waggably	wggbly
waggishly	wggshly
wailfully	wlflly
wailingly	wlngly
waistband	wstbnd
wait	wt
waitingly	wtngly
waitress	wtrss
wakefully	wkflly
wakingly	wkngly
walk	wlk
walker	wlkr
walkway	wlkwy
wallaby	wllby
wallet	wllt
walnut	wlnt
walrus	wlrs
wambly	wmbly
wampum	wmpm
wankly	wnkly
wannabe	wnnb
wantingly	wntngly
wantonly	wntnly
warbly	wrbly
warden	wrdn
warily	wrly
warlikely	wrlkly
warlock	wrlck
warm-up	wrm-p
warmedly	wrmdly
warmly	wrmly
warmth	wrmth
warning	wrnng
warningly	wrnngly
wash	wsh
washbasin	wshbsn
washcloth	wshclth
washer	wshr
washtub	wshtb
wasp	wsp
waspily	wsply
waspishly	wspshly
waste	wst
wastebasket	wstbskt
wastefully	wstflly
wastingly	wstngly
watchmaker	wtchmkr
water	wtr
waterbed	wtrbd
waterbelly	wtrblly
waterfall	wtrfll
waterily	wtrly
wateringly	wtrngly
waterishly	wtrshly
waterskiing	wtrskng
waterspout	wtrspt
wavably	wvbly
wave	wv
wavelessly	wvlssly
waveringly	wvrngly
waves	wvs
wavingly	wvngly
wax	wx
waxily	wxly
waxingly	wxngly
way	wy
waywardly	wywrdly
weakishly	wkshly
weakly	wkly
weakness	wknss
wealth	wlth
wealthily	wlthly
weapon	wpn
wear	wr
weariedly	wrdly
wearifully	wrflly
wearilessly	wrlssly
wearishly	wrshly
wearisomely	wrsmly
wearyingly	wryngly
weasel	wsl
weaselly	wslly
weather	wthr
weatherly	wthrly
web	wb
weddedly	wdddly
wedding	wddng
wedge	wdg
weeder	wdr
weedkiller	wdkllr
week	wk
weekend	wknd
weekender	wkndr
weepingly	wpngly
weevily	wvly
weight	wght
weightedly	wghtdly
weird	wrd
welcome	wlcm
welcomely	wlcmly
welfare	wlfr
westerly	wstrly
western	wstrn
westernly	wstrnly
wet-bar	wt-br
wetly	wtly
wetsuit	wtst
wharf	whrf
whealy	whly
wheat	wht
wheel	whl
wheelingly	whlngly
wheezily	whzly
wheezingly	whzngly
whereas	whrs
whilly	whlly
whiningly	whnngly
whip	whp
whipbelly	whpblly
whirlpool	whrlpl
whirlwind	whrlwnd
whirly	whrly
whisker	whskr
whiskey	whsky
whistle	whstl
whistly	whstly
whitebelly	whtblly
whitely	whtly
wholesale	whlsl
wholesalely	whlslly
wholesaler	whlslr
wholesomely	whlsmly
whoopingly	whpngly
whorishly	whrshly
whorl	whrl
wickedly	wckdly
widowly	wdwly
width	wdth
wife	wf
wifely	wfly
wiggly	wggly
wightly	wghtly
wilderedly	wldrdly
wilderness	wldrnss
wildishly	wldshly
wildlife	wldlf
wildly	wldly
wilily	wlly
will	wll
willfully	wllflly
willingly	wllngly
willow	wllw
willy	wlly
wilsomely	wlsmly
wily	wly
wincingly	wncngly
wind	wnd
wind-chime	wnd-chm
windage	wndg
windily	wndly
windmilly	wndmlly
window	wndw
windscreen	wndscrn
windshield	wndshld
wine	wn
wing	wng
wingedly	wngdly
wingman	wngmn
wingtip	wngtp
winkingly	wnkngly
winly	wnly
winner	wnnr
winningly	wnnngly
winsomely	wnsmly
winter	wntr
winterly	wntrly
wisdom	wsdm
wiseguy	wsgy
wisely	wsly
wishedly	wshdly
wishfully	wshflly
wishingly	wshngly
wishly	wshly
wisteria	wstr
witch	wtch
witchedly	wtchdly
withdrawal	wthdrwl
witheredly	wthrdly
witlessly	wtlssly
witness	wtnss
wittily	wttly
wittingly	wttngly
wittolly	wttlly
wizardly	wzrdly
wobbly	wbbly
woefully	wflly
wolf	wlf
wolfishly	wlfshly
womanfully	wmnflly
womanishly	wmnshly
womanly	wmnly
wombat	wmbt
women	wmn
wonder	wndr
wondrously	wndrsly
wontedly	wntdly
woodenly	wdnly
woodland	wdlnd
woodly	wdly
woodshed	wdshd
woodwind	wdwnd
wooingly	wngly
wool	wl
woolen	wln
wordably	wrdbly
wordishly	wrdshly
work	wrk
workbench	wrkbnch
worker	wrkr
workhorse	wrkhrs
working	wrkng
workingly	wrkngly
worklife	wrklf
workmanly	wrkmnly
workshop	wrkshp
world	wrld
worldlily	wrldlly
worldly	wrldly
worm	wrm
worriedly	wrrdly
worrisomely	wrrsmly
worry	wrry
worth	wrth
worthy	wrthy
woundedly	wnddly
woundingly	wndngly
wraitly	wrtly
wrap	wrp
wraparound	wrprnd
wrecker	wrckr
wren	wrn
wrench	wrnch
wrestler	wrstlr
wriggly	wrggly
wrinkle	wrnkl
wrinkly	wrnkly
wrist	wrst
writer	wrtr
writhedly	wrthdly
writing	wrtng
wrong	wrng
wrongly	wrngly
wrongously	wrngsly
wrothily	wrthly
wryly	wryly
xerically	xrclly
xerophily	xrphly
xylophone	xylphn
yacht	ycht
yak	yk
yam	ym
yaply	yply
yappingly	yppngly
yard	yrd
yarly	yrly
yarmulke	yrmlk
yarn	yrn
yawl	ywl
yawnfully	ywnflly
yawnily	ywnly
yawningly	ywnngly
year	yr
yearnfully	yrnflly
yeast	yst
yeastily	ystly
yellow	yllw
yellowly	yllwly
yeomanly	ymnly
yesterday	ystrdy
yew	yw
yieldingly	yldngly
yin	yn
yoga	yg
yogurt	ygrt
you	y
young	yng
youngly	yngly
youth	yth
youthfully	ythflly
youthily	ythly
yurt	yrt
zampone	zmpn
zealously	zlsly
zebra	zbr
zebrafish	zbrfsh
zephyr	zphyr
zestfully	zstflly
ziggurat	zggrt
zinc	znc
zipper	zppr
zippingly	zppngly
zither	zthr
zonally	znlly
zone	zn
zoo	z
zoologically	zlgclly
zoologist	zlgst
zoology	zlgy
zoophily	zphly
zoot-suit	zt-st
zootomically	ztmclly
zucchini	zcchn
